唯一	唯一 ゆいいつ only; sole; unique
生地	生地 きじ cloth; fabric; material; texture; one's true character; unglazed pottery; uncooked dough; batter
続き	続き つづき sequel; continuation; (also suffix) continuation (in time and space); second series; succession; spell
合計	合計 ごうけい sum total; total amount
流れ	流れ ながれ stream; current; flow; course of events
化学	化学 かがく chemistry; chemical company (e.g. Acme Chemical Co.)
意外	意外 いがい unexpected; surprising
土地	土地 とち plot of land; lot; soil; locality; region; place
恐怖	恐怖 きょうふ fear; dread; dismay; terror; horror; scare; panic
発行	発行 はっこう issue (publications); publishing; raising an event (software)
契約	契約 けいやく contract; compact; agreement
協力	協力 きょうりょく cooperation; collaboration
食事	食事 しょくじ meal; to eat
一体	一体 いったい ...the heck (e.g. "what the heck?"); ...in the world (e.g. "why in the world?"); ...on earth (e.g. "who on earth?"); one object; one body; unity; one form; one style; one Buddhist image (or carving, etc.); generally; in general
担当	担当 たんとう being in charge (of an area of responsibility); being responsible (for a work role, etc.)
今後	今後 こんご from now on; hereafter
ほぼ	ほぼ ほぼ almost; roughly; approximately
舞台	舞台 ぶたい stage (theatre, theater); scene or setting (e.g. of novel, play, etc.)
観光	観光 かんこう sightseeing
記録	記録 きろく record; minutes; document; a record (e.g. in sports); results; score; to record; to document; to set a record (e.g. in sports); to show a result; to reach a value
太陽	太陽 たいよう sun; solar
一生	一生 いっしょう whole life; a lifetime; all through life; one existence; a generation; an age; the whole world; the era; (the only, the greatest, etc.) of one's life
満足	満足 まんぞく satisfaction; contentment; complacency; sufficient; enough; adequate; proper
玉	玉 たま ball; sphere; globe; orb; bead (of sweat, dew, etc.); drop; droplet; ball (in sports); pile (of noodles, etc.); bullet; bulb (i.e. a light bulb); lens (of glasses, etc.); bead (of an abacus); ball (i.e. a testicle); gem; jewel (esp. spherical; sometimes used figuratively); pearl; female entertainer (e.g. a geisha); person (when commenting on their nature); character; item, funds or person used as part of a plot; egg; coin; precious; beautiful; excellent
印刷	印刷 いんさつ printing
活用	活用 かつよう practical use; application; conjugation; declension; inflection
柄	柄 がら pattern; design; body build; figure; physique; essential qualities; character; nature; appropriate to; fitting of; suitable for
読み	読み よみ reading
絶対	絶対 ぜったい absolutely; unconditionally; absolute; unconditional; unmistakable; absoluteness
変化	変化 へんか change; variation; alteration; mutation; transition; transformation; transfiguration; metamorphosis; variety; diversity; inflection; declension; conjugation; sidestepping
全て	全て すべて everything; all; the whole; entirely; completely; wholly; all
差	差 さ difference; variation; difference
地下	地下 ちか basement; cellar; underground place; underground; below ground; secret; under cover; underground (railway); subway; metro
筋	筋 すじ muscle; tendon; sinew; vein; artery; fiber; fibre; string; line; stripe; streak; reason; logic; plot; storyline; lineage; descent; school (e.g. of scholarship or arts); aptitude; talent; source (of information, etc.); circle; channel; well-informed person (in a transaction); logical move (in go, shogi, etc.); ninth vertical line; seam on a helmet; gristly fish paste (made of muscle, tendons, skin, etc.); social position; status; on (a river, road, etc.); along; counter for long thin things; counter for roads or blocks when giving directions; (Edo period) counter for hundreds of mon (obsolete unit of currency)
不安	不安 ふあん anxiety; uneasiness; insecurity; suspense
酒	酒 さけ alcohol; sake
又	又 また again; and; also; still (doing something)
都会	都会 とかい city; Tokyo Metropolitan Assembly
値段	値段 ねだん price; cost
費用	費用 ひよう cost; expense
経営	経営 けいえい management; administration; operation; running (business); conducting
理想	理想 りそう ideal; ideals
感情	感情 かんじょう emotion; feeling; feelings; sentiment
選手	選手 せんしゅ player (in game); team member
長期	長期 ちょうき long-term
際	際 さい on the occasion of; circumstances; juncture
中学	中学 ちゅうがく middle school; junior high school
組織	組織 そしき organization; organisation; structure; construction; tissue; system
是非	是非 ぜひ certainly; without fail; right and wrong; pros and cons
訪問	訪問 ほうもん call; visit
友	友 とも friend; companion; comrade; pal
管	管 かん pipe; tube
波	波 なみ wave
新た	新た あらた new; fresh; novel
温度	温度 おんど temperature
美人	美人 びじん beautiful woman
学習	学習 がくしゅう study; learning; tutorial
作家	作家 さっか author; writer; novelist; artist
委員	委員 いいん committee member
武器	武器 ぶき weapon; arms; ordnance; weapon (something used to gain an advantage); asset
友人	友人 ゆうじん friend
現代	現代 げんだい nowadays; modern era; modern times; present-day
一方	一方 いっぽう one (esp. of two); the other; one way; the other way; one direction; the other direction; one side; the other side; one party; the other party; on the one hand; on the other hand; whereas; although; but at the same time; meanwhile; in turn; just keeps; being inclined to ...; tending to be ...; tending to do ...; continuously ...; just keeps on ...ing; only
ただ	ただ ただ ordinary; common; usual; free of charge; unaffected; as is; safe; only; merely; just; simply; but; however; nevertheless
行き	行き ゆき bound for ...; going (to)
建築	建築 けんちく construction; architecture (of buildings)
装置	装置 そうち equipment; installation; apparatus; device; unit
患者	患者 かんじゃ (a) patient
実は	実は じつは as a matter of fact; by the way; to tell you the truth; to be honest; frankly
残り	残り のこり remnant; residue; remaining; left-over
性格	性格 せいかく character; personality; disposition; nature
刺激	刺激 しげき stimulus; impetus; incentive; encouragement; motivation; provocation; excitement; thrill
計画	計画 けいかく plan; project; schedule; scheme; program; programme
請求	請求 せいきゅう claim; demand; charge; application; request; billing (for a service)
球	球 きゅう sphere; counter for balls
本物	本物 ほんもの genuine article; real thing; real deal
物語	物語 ものがたり tale; story; legend
修理	修理 しゅうり repairing; mending; servicing
化粧	化粧 けしょう make-up; makeup; cosmetics
適用	適用 てきよう applying (e.g. a technology); adoption
教授	教授 きょうじゅ professor; teaching; instruction
茶	茶 ちゃ tea; tea plant (Camellia sinensis); tea preparation; making tea; brown; mockery
同一	同一 どういつ identical; same; one and the same; equal; fair; equal treatment; without discrimination
巨大	巨大 きょだい huge; gigantic; enormous
博士	博士 はかせ doctorate; PhD; Dr (as a title); expert; learned person
端	端 はし end (e.g. of street); tip; point; edge; margin; beginning; start; first; odds and ends; scrap; odd bit; least
何か	何か なにか something
布	布 ぬの cloth; bujian (spade-shaped bronze coin of ancient China)
思想	思想 しそう thought; idea; ideology
豊富	豊富 ほうふ abundance; wealth; plenty; bounty
年齢	年齢 ねんれい age; years
検査	検査 けんさ inspection (e.g. customs, factory); examination; scan (e.g. MRI, PET, etc.)
文明	文明 ぶんめい civilization; civilisation; culture; Bummei era (1469.4.28-1487.7.20)
雰囲気	雰囲気 ふんいき mood; ambience; ambiance; aura; feel; a certain air; presence; special aura; something (about someone); air; atmosphere
団体	団体 だんたい organization; organisation; association
伝統	伝統 でんとう tradition; convention
他人	他人 たにん another person; other people; others; unrelated person (i.e. not related by blood); outsider; stranger
重大	重大 じゅうだい serious; important; significant; grave; weighty
服装	服装 ふくそう garments; attire
信頼	信頼 しんらい reliance; trust; faith; confidence