物価	物価 ぶっか prices of commodities; prices (in general); cost-of-living
金	金 きん gold (Au); golden (color); gold (medal, cup); valuable; of highest value; money; gold coin (orig. meaning); Friday; metal (fourth of the five elements); Jin (dynasty of China; 1115-1234 CE); gold general; testicles; karat; carat
金	金 かね money; metal
性	性 せい nature (of a person); sex; gender; -ty; -ity; -ness; -cy
文	文 ぶん sentence; composition; text; writings; the literary arts (as opposed to the military arts); academia; literature
雷	雷 かみなり lightning; thunder; thunderbolt; god of thunder; god of lightning; anger; fit of anger
不	不 ふ un-; non-; negative prefix
見舞い	見舞い みまい visiting ill or distressed people; writing get-well letters; get-well gifts; get-well letters; expression of sympathy; expression of concern; enquiry; inquiry
法	法 ほう law; act; principle; method; mood; dharma
湾	湾 わん bay; gulf; inlet
語学	語学 ごがく language study
光景	光景 こうけい scene; spectacle; sight; view
汚染	汚染 おせん pollution; contamination
給料	給料 きゅうりょう salary; wages
面	面 めん face; mask; face guard; (in kendo) striking the head; surface (esp. a geometrical surface); page; aspect; facet; side; chamfer; counter for broad, flat objects, levels or stages, e.g. in a video game
味方	味方 みかた friend; ally; supporter
数	数 すう several; a number of; quantity; amount; counting; figures; numbers; number; numeral; figure; grammatical number; destiny; fate; course of events; trend
表	表 ひょう table (e.g. Table 1); chart; list
商売	商売 しょうばい trade; business; commerce; transaction; occupation
ボール	ボール ボール ball; bowl; board (e.g. cardboard, pasteboard)
専攻	専攻 せんこう major subject; special study
無	無 ぶ un-; non-; bad ...; poor ...
無	無 む nothing; naught; nought; nil; zero; un-; non-
急激	急激 きゅうげき sudden; precipitous; radical
心臓	心臓 しんぞう heart; guts; nerve; cheek; gall; spine; central part
市	市 いち market; fair
涙	涙 なみだ tear; tears; lachrymal secretion; sympathy
多分	多分 たぶん perhaps; probably; generous; many; much; great
殺す	殺す ころす to kill
離れる	離れる はなれる to be separated; to be apart; to be distant; to leave; to go away; to leave (a job, etc.); to quit; to give up; to lose connection with; to drift away from
職	職 しょく job; work; employment; occupation; position; duties; trade; skill
品	品 ひん elegance; grace; refinement; class; dignity; article; item; counter for items (of food, etc.); counter for dishes or courses (at a restaurant)
品	品 しな article; item; thing; goods; stock; quality; flirtatiousness; coquetry
元	元 もと former; ex-; past; one-time
集まり	集まり あつまり gathering; meeting; assembly; collection; attendance
受け取る	受け取る うけとる to receive; to get; to accept; to take; to interpret; to understand
火災	火災 かさい conflagration; fire
申し訳	申し訳 もうしわけ apology; excuse
追う	追う おう to chase; to run after; to pursue; to follow (i.e. a set order, a trend); to drive out; to oust; to expel; to drive (i.e. a herd); (in passive voice) to be pressed (for time, etc.)
罪	罪 つみ crime; sin; wrongdoing; indiscretion; penalty; sentence; punishment; fault; responsibility; culpability; thoughtlessness; lack of consideration
嫁	嫁 よめ wife; bride; (one's) daughter-in-law
延期	延期 えんき postponement; adjournment
単なる	単なる たんなる mere; simple; sheer
座席	座席 ざせき seat
順調	順調 じゅんちょう favourable; favorable; doing well; OK; all right
悲劇	悲劇 ひげき tragedy; tragic drama; tragic play; tragedy; calamity; disaster
半ば	半ば なかば middle; half; semi; halfway; partly
独身	独身 どくしん bachelorhood; single; unmarried; celibate
学問	学問 がくもん scholarship; study; learning; discipline; branch of learning; (a) science
禁煙	禁煙 きんえん abstaining from smoking; quitting smoking; No Smoking!; Smoking Prohibited!
借金	借金 しゃっきん debt; loan; liabilities
乗客	乗客 じょうきゃく passenger
他	他 ほか other (place, thing, person); the rest; outside; beyond; nothing except; nothing but; nothing apart from; nothing aside from; no choice (but to); besides...; in addition to...
句	句 く section (i.e. of text); sentence; passage; paragraph; phrase; verse (of 5 or 7 mora in Japanese poetry; of 4, 5, or 7 characters in Chinese poetry); haiku; first 17 morae of a renga, etc.; maxim; saying; idiom; expression
式	式 しき equation; formula; expression; ceremony; style; enforcement regulations (of the ritsuryo)
慎重	慎重 しんちょう careful; cautious; prudent; discreet; deliberate
審判	審判 しんぱん refereeing; trial; judgement; judgment; umpire; referee
同僚	同僚 どうりょう coworker; co-worker; colleague; associate
許す	許す ゆるす to permit; to allow; to approve; to tolerate; to exempt (from fine); to excuse (from); to pardon; to forgive; to release; to let off; to confide in; to give up; to yield
信仰	信仰 しんこう (religious) faith; belief; creed
迎え	迎え むかえ meeting; greeting; welcome
騒音	騒音 そうおん noise
軍隊	軍隊 ぐんたい armed forces; military; troops
農民	農民 のうみん farmers; peasants
位	位 くらい throne; crown; (nobleman's) seat; government position; court rank; social standing; rank; class; echelon; rung; grade (of quality, etc.); level; tier; rank; digit (e.g. the tens, the hundreds, etc.); place; degree; extent; amount
限る	限る かぎる to restrict; to limit; to confine; to be restricted to; to be limited to; to be confined to
人種	人種 じんしゅ race (of people); type of person
滞在	滞在 たいざい stay; sojourn
休暇	休暇 きゅうか holiday; day off; furlough; absence (from work)
為る	為る する to do; to cause to become; to make (into); to turn (into); to serve as; to act as; to work as; to wear (clothes, a facial expression, etc.); to judge as being; to view as being; to think of as; to treat as; to use as; to decide on; to choose; to be sensed (of a smell, noise, etc.); to be (in a state, condition, etc.); to be worth; to cost; to pass (of time); to elapse; to place, or raise, person A to a post or status B; to transform A to B; to make A into B; to exchange A for B; to make use of A for B; to view A as B; to handle A as if it were B; to feel A about B; verbalizing suffix (applies to nouns noted in this dictionary with the part of speech "vs"); creates a humble verb (after a noun prefixed with "o" or "go"); to be just about to; to be just starting to; to try to; to attempt to
旗	旗 はた flag
県	県 けん prefecture (of Japan); county (of China)
炎	炎 ほのお flame; blaze; flames (of intense emotion, e.g. love, jealousy, anger); passion
節約	節約 せつやく economising; saving
進歩	進歩 しんぽ progress; advance; improvement; development
愛する	愛する あいする to love
食卓	食卓 しょくたく dining table
論争	論争 ろんそう controversy; dispute
解釈	解釈 かいしゃく explanation; interpretation
豆	豆 まめ legume (esp. edible legumes or their seeds, such as beans, peas, pulses, etc.); beans; peas; soya bean (Glycine max); soybean; soy; female genitalia (esp. the clitoris); kidney; miniature; tiny; child
失う	失う うしなう to lose; to part with
勇気	勇気 ゆうき courage; bravery; valour; valor; nerve; boldness
結ぶ	結ぶ むすぶ to tie; to bind; to link; to bear (fruit); to close (e.g. deal); to confirm; to conclude; to connect (two distant places); to close tightly; to purse (e.g. lips); to unite (with); to ally; to join hands
高価	高価 こうか high price
オフィス	オフィス オフィス office
署名	署名 しょめい signature
量	量 りょう quantity; amount; volume; portion (of food)
貯金	貯金 ちょきん putting money aside; savings; deposit (e.g. in a bank); accumulated surplus of wins; wins in the bank
流す	流す ながす to drain; to pour; to spill; to shed (blood, tears); to wash away; to distribute (e.g. electricity over wires, music over a PA system, etc.); to circulate; to broadcast; to beam; to cruise (e.g. taxi); to float; to set adrift; to call off (a meeting, etc.)
握手	握手 あくしゅ handshake
自慢	自慢 じまん pride; boast
終える	終える おえる to finish; to graduate
等	等 など et cetera; etc.; and the like; and so forth; or something; the likes of
酸素	酸素 さんそ oxygen (O)
番	番 ばん number (in a series); (one's) turn; watch; guard; lookout; bout; match
文句	文句 もんく complaint; grumbling; objection; phrase; words; expression
贈る	贈る おくる to give (as a gift); to present; to confer; to bestow; to award
連れ	連れ つれ companion; company
瓶	瓶 びん bottle; jar; decanter; flagon; phial; vial
不自由	不自由 ふじゆう discomfort; inconvenience; poverty; want; destitution; disability; impairment (physical, mental, etc.)