きつい	きつい きつい intense; severe; hard; determined; forceful; formidable; strong; tight; close
鼠	鼠 ねずみ mouse; rat; dark gray; dark grey; slate (color, colour)
お互い	お互い おたがい mutual; reciprocal; each other
ノック	ノック ノック knock; knocking; fungo hitting; hitting balls for fielding practice
切れる	切れる きれる to break; to snap; to be cut; to split; to crack; to be injured; to wear out; to be worn out; to break; to burst; to collapse; to wear off; to stop working; to go dead; to expire (time limit, etc.); to run out; to become due; to run out (of stock, etc.); to be exhausted; to be used up; to be sold out; to be out of; to be broken off (e.g. of a relationship); to break up; to have severed ties; to be cut off; to be disconnected; to cut well; to be sharp; to be sharp-minded; to be keen; to be shrewd; to be quick-witted; to be able; to be short of; to drop under (a certain figure); to beat (e.g. a record time); to dry off; to curve; to veer; to shuffle (cards); to get angry; to snap; to blow one's top; to lose one's temper; to flip; to be able to do completely
進める	進める すすめる to advance; to promote; to hasten
かわいらしい	かわいらしい かわいらしい lovely; sweet
わがまま	わがまま わがまま selfishness; egoism; self-indulgence; wilfulness; willfulness; disobedience; whim
およそ	およそ およそ about; roughly; approximately; generally; on the whole; as a rule; completely; quite; entirely; altogether; totally; not at all (with neg. verb); outline; gist
売れる	売れる うれる to sell (well); to be well known; to be popular; to be famous
違いない	違いない ちがいない (phrase) sure; no mistaking it; for certain
輝く	輝く かがやく to shine; to glitter; to sparkle
節	節 ふし joint; knuckle; tune; melody; knot (in wood); node in a bamboo stem; part; notable characteristic
なぜなら	なぜなら なぜなら because; the reason is; if you want to know why
沈む	沈む しずむ to sink; to go under; to submerge; to go down (e.g. sun); to set; to descend; to feel depressed
逆らう	逆らう さからう to go against; to oppose; to disobey; to defy
抜ける	抜ける ぬける to come out; to fall out; to be omitted; to be missing; to escape; to come loose; to fade; to discolour; to wear a hole (e.g. clothes); to leave (e.g. a meeting); to be clear; to be transparent (e.g. of the sky); to be stupid; to be absentminded; to be careless; to be inattentive; to exit (a program loop)
酔う	酔う よう to get drunk; to become intoxicated; to feel sick (e.g. in a vehicle); to become nauseated; to be elated; to be exalted; to be spellbound; to be in raptures
スピーチ	スピーチ スピーチ speech
一度に	一度に いちどに all at once
増す	増す ます to increase; to grow
パーセント	パーセント パーセント percent; percentage
褒める	褒める ほめる to praise; to admire; to speak well of someone
知らせ	知らせ しらせ news; word; tidings; notice; notification; information; omen
しばしば	しばしば しばしば (blinking) repeatedly
じっと	じっと じっと motionlessly (e.g. stand, wait); (be) still; fixedly (e.g. gaze, stare); intently (e.g. listen, think); patiently (endure); stoically; firmly (e.g. hold); restrained
ユーモア	ユーモア ユーモア humor; humour
幼い	幼い おさない very young; childish; immature
覚ます	覚ます さます to awaken; to disabuse; to sober up
明後日	明後日 あさって day after tomorrow
譲る	譲る ゆずる to turn over; to assign; to hand over; to transmit; to convey; to sell; to dispose of; to yield; to surrender; to concede
辛い	辛い つらい painful; bitter; heart-breaking; difficult (emotionally); tough; difficult; hard (usu. of situations); cruel; harsh; cold
うがい	うがい うがい gargling; rinsing one's mouth
大した	大した たいした considerable; great; important; significant; a big deal
がっかり	がっかり がっかり feel disappointed; dejected; lose heart; feel emotionally drained; feel let down
打つ	打つ ぶつ to hit (a person); to strike; to beat
紐	紐 ひも string; cord; man who is financially dependent on a woman (such as a gigolo or, in the case of a prostitute, a pimp); pimp
苦しむ	苦しむ くるしむ to suffer; to groan; to be worried
通す	通す とおす to stick through; to force through; to spread throughout; to thoroughly diffuse; to make a path between two points; to proceed in a logical manner; to let pass; to allow through; to lead (someone) into (a house, room, etc.); to show in; to go through (a middleman); to (look, listen) through (a window, wall, etc.); to pass (a law, applicant, etc.); to force to accept; to force agreement; to continue (in a state); to persist in; to do to the entirety of; to cover all of; to span the whole ...; to do from beginning to end without a break; to convey (one's ideas, etc.) to the other party; to do to the end; to carry through; to complete
効く	効く きく to be effective; to show effect; to do its work; to carry out its function well; to be possible to use
ぐっすり	ぐっすり ぐっすり sound asleep; fast asleep
しゃべる	しゃべる しゃべる to talk; to chat; to chatter
対	対 つい pair; couple; set; antithesis; counter for items that come in pairs; counter for sets (of clothes, small furniture, utensils, etc.)
先ず	先ず まず first (of all); to start with; about; almost; anyway; well; now; hardly (with neg. verb)
ハンサム	ハンサム ハンサム handsome
抜く	抜く ぬく to extract; to omit; to draw out; to unplug; to do something to the end; to surpass; to overtake; to masturbate (of a male); to ejaculate (while masturbating); to take (a photo); to record (video)
塵	塵 ごみ rubbish; trash; garbage; refuse
平ら	平ら たいら flatness; level; smooth; calm; plain; sitting tailor fashion
濡れる	濡れる ぬれる to get wet
解く	解く とく to untie; to unfasten; to unwrap; to undo; to unbind; to unpack; to unsew; to unstitch; to solve; to work out; to answer; to dispel (misunderstanding, etc.); to clear up; to remove (suspicion); to appease; to dissolve (a contract); to cancel; to remove (a prohibition); to lift (a ban); to raise (a siege); to release (from duty); to relieve; to dismiss; to comb (out); to card; to untangle (hair)
向く	向く むく to face; to turn toward; to be suited to; to be fit for
綿	綿 めん cotton
触れる	触れる ふれる to touch; to feel; to experience; to come in contact with; to be emotionally moved (by); to perceive; to touch on a subject; to allude to; to be in conflict (with); to violate (law, copyright, etc.); to proclaim
灰	灰 はい ash; ashes
タイプライター	タイプライター タイプライター typewriter
向ける	向ける むける to turn towards; to point
ぼんやり	ぼんやり ぼんやり dimly; faintly; indistinctly; vaguely; absentmindedly; vacantly; carelessly; idly; aimlessly; absence of mind; fool; blockhead; dunce
あいにく	あいにく あいにく unfortunately; Sorry, but ...
優れる	優れる すぐれる to surpass; to outstrip; to excel
真っ直ぐ	真っ直ぐ まっすぐ straight (ahead); direct; upright; erect; straightforward; honest; frank
怪我	怪我 けが injury (to animate object); hurt
直に	直に じかに directly; in person; firsthand
止す	止す よす to cease; to desist; to cut it out; to lay off (an activity); to drop (a subject) to abolish; to resign; to give up
下す	下す おろす to take down (e.g. flag); to launch (e.g. boat); to drop; to lower (e.g. ladder); to let (a person) off; to unload; to discharge; to drop off (a passenger from a vehicle); to let (a person) off; to withdraw money from an account; to wear (clothing) for the first time; to fillet (e.g. a fish)
ざっと	ざっと ざっと roughly; in round numbers; cursorily; briefly
伸びる	伸びる のびる to stretch; to extend; to lengthen; to spread; to make progress; to grow (beard, body height); to grow stale (soba); to be straightened; to be flattened; to be smoothed; to be exhausted
被る	被る かぶる to put on (one's head); to wear; to have on; to pull over (one's head); to crown (oneself); to be covered with (dust, snow, etc.); to pour (water, etc.) on oneself; to dash on oneself; to ship water; to bear (e.g. someone's debts, faults, etc.); to take (blame); to assume (responsibility); to shoulder (burden); to overlap (e.g. sound or color); to be similar; to be redundant; to be fogged (due to overexposure, etc.); to close; to come to an end; to get a full house; to sell out; to blunder; to bungle; to fail; to be deceived
にっこり	にっこり にっこり smile sweetly; smile; grin
捕まる	捕まる つかまる to be caught; to be arrested; to hold on to; to grasp; to find (e.g. proof); to get (e.g. a taxi); to be detained by
いらいら	いらいら いらいら getting nervous; irritation
避ける	避ける さける to avoid (physical contact with); to avoid (situation); to ward off; to avert
従う	従う したがう to abide (by the rules); to obey; to follow; to accompany
述べる	述べる のべる to state; to express; to mention
責める	責める せめる to condemn; to blame; to criticize; to criticise; to reproach; to accuse; to urge; to press; to pester; to torture; to torment; to persecute; to break in (a horse)
今にも	今にも いまにも at any time; soon
ばったり	ばったり ばったり with a clash; with a thud; with a bang; with a flop; plump; unexpectedly (meeting someone); suddenly (ending); abruptly (coming to a halt)
抱く	抱く いだく to embrace; to hold in the arms (e.g. a baby); to hug; to harbour (e.g. grudge); to harbor; to bear; to have (e.g. ambition); to entertain (e.g. hope, suspicion); to have sex with; to make love to; to sleep with; to sit on eggs
少しも	少しも すこしも anything of; not one bit (with negative sentence)
放す	放す はなす to release; to let go; to free; to set free; to let loose; to turn loose; to add (pieces of eggplant, potato, etc.) to water, broth, etc.
明ける	明ける あける to dawn; to grow light; to end (of a period, season); to begin (of the New Year)
人込み	人込み ひとごみ crowd of people
計る	計る はかる to measure; to weigh; to survey; to time (sound, gauge, estimate); to conjecture; to infer; to surmise
解ける	解ける とける to be solved; to loosen; to come untied; to be removed (e.g. restrictions); to be cleared (e.g. misunderstandings); to be broken (e.g. spells, curses); to melt
説	説 せつ theory; doctrine; opinion; view; rumour; rumor; gossip; hearsay
注ぐ	注ぐ つぐ (usu. written as kana when referring to a solid) to pour (into a vessel); to fill; to dish out food or drink
任せる	任せる まかせる to entrust (e.g. a task) to another; to leave to; to passively leave to someone else's facilities; to leave to take its natural course; to continue (something) in a natural fashion (without particular aim); to rely fully on one's (full strength, great ability, long time taken) to get something done
しきりに	しきりに しきりに frequently; repeatedly; often; incessantly; constantly; strongly; eagerly
遂に	遂に ついに finally; at last; in the end
よると	よると よると according to
済ませる	済ませる すませる to finish; to make an end of; to get through with; to let end
粗い	粗い あらい coarse; rough
占める	占める しめる to occupy; to hold; to account for; to make up; to take up
空く	空く すく to become less crowded; to thin out; to get empty; to be hungry
近頃	近頃 ちかごろ lately; recently; nowadays
隠れる	隠れる かくれる to hide; to be hidden; to conceal oneself; to disappear
履く	履く はく to put on (or wear) lower-body clothing (i.e. pants, skirt, etc.); to put on (or wear) footwear; to affix a sword to one's hip; to affix a bowstring to a bow
留める	留める とめる to stop; to turn off; to park; to prevent; to suppress (a cough); to hold back (tears); to hold (one's breath); to relieve (pain); to stop (someone from doing something); to dissuade; to forbid; to prohibit; to notice; to be aware of; to concentrate on; to pay attention to; to remember; to bear in mind; to fix (in place); to fasten; to tack; to pin; to nail; to button; to staple; to detain; to keep in custody
省く	省く はぶく to omit; to leave out; to exclude; to eliminate; to elide; to curtail; to save; to cut down; to economize; to economise
けち	けち けち stinginess; miser; miserliness; selfishness
招く	招く まねく to invite; to ask; to beckon; to wave someone in; to gesture to; to call in; to send for; to summon; to bring on oneself; to cause; to incur; to lead to; to result in