佐藤	さとう Satou
鈴木	すずき Suzuki
高橋	たかはし Takahashi
田中	たなか Tanaka
渡辺	わたなべ Watanabe
伊藤	いとう Itou
山本	やまもと Yamamoto
中村	なかむら Nakamura
小林	こばやし Kobayashi
加藤	かとう Katou
吉田	よしだ Yoshida
山田	やまだ Yamada
佐々木	ささき Sasaki
山口	やまぐち Yamaguchi
松本	まつもと Matsumoto
井上	いのうえ Inoue
斎藤	さいとう Saitou
木村	きむら Kimura
林	はやし Hayashi
清水	しみず Shimizu
山崎	やまざき Yamazaki
池田	いけだ Ikeda
阿部	あべ Abe
森	もり Mori
橋本	はしもと Hashimoto
山下	やました Yamashita
石川	いしかわ Ishikawa
中島	なかじま Nakajima
前田	まえだ Maeda
藤田	ふじた Fujita
小川	おがわ Ogawa
岡田	おかだ Okada
後藤	ごとう Gotou
長谷川	はせがわ Hasegawa
村上	むらかみ Murakami
近藤	こんどう Kondou
石井	いしい Ishii
坂本	さかもと Sakamoto
遠藤	えんどう Endou
青木	あおき Aoki
藤井	ふじい Fujii
西村	にしむら Nishimura
福田	ふくだ Fukuda
太田	おおた Oota
三浦	みうら Miura
藤原	ふじわら Fujiwara
岡本	おかもと Okamoto
松田	まつだ Matsuda
斉藤	さいとう Saitou
中川	なかがわ Nakagawa
中野	なかの Nakano
原田	はらだ Harada
小野	おの Ono
竹内	たけうち Takeuchi
田村	たむら Tamura
金子	かねこ Kaneko
和田	わだ Wada
中山	なかやま Nakayama
石田	いしだ Ishida
上田	うえだ Ueda
森田	もりた Morita
原	はら Hara
柴田	しばた Shibata
酒井	さかい Sakai
工藤	くどう Kudou
横山	よこやま Yokoyama
宮崎	みやざき Miyazaki
宮本	みやもと Miyamoto
内田	うちだ Uchida
高木	たかぎ Takagi
安藤	あんどう Andou
谷口	たにぐち Taniguchi
大野	おおの Oono
今井	いまい Imai
丸山	まるやま Maruyama
高田	たかだ Takada
河野	こうの Kouno
藤本	ふじもと Fujimoto
小島	こじま Kojima
武田	たけだ Takeda
村田	むらた Murata
上野	うえの Ueno
杉山	すぎやま Sugiyama
増田	ますだ Masuda
菅原	すがわら Sugawara
平野	ひらの Hirano
小山	こやま Koyama
大塚	おおつか Ootsuka
久保	くぼ Kubo
千葉	ちば Chiba
松井	まつい Matsui
岩崎	いわさき Iwasaki
野口	のぐち Noguchi
松尾	まつお Matsuo
木下	きした Kishita
菊地	きくち Kikuchi
野村	のむら Nomura
佐野	さの Sano
渡部	わたなべ Watanabe
新井	あらい Arai