内山	うちやま Uchiyama
桑原	くわばら Kuwabara
岡	おか Oka
富田	とみだ Tomida
関口	せきぐち Sekiguchi
松永	まつなが Matsunaga
奥田	おくだ Okuda
北川	きたがわ Kitagawa
古賀	こが Koga
上原	うえはら Uehara
八木	やぎ Yagi
吉野	よしの Yoshino
白石	しらいし Shiraishi
今村	いまむら Imamura
川島	かわしま Kawashima
上村	うえむら Uemura
小泉	こいずみ Koizumi
中尾	なかお Nakao
青山	あおやま Aoyama
平山	ひらやま Hirayama
牧野	まきの Makino
寺田	てらだ Terada
渋谷	しぶたに Shibutani
岡村	おかむら Okamura
児玉	こだま Kodama
坂口	さかぐち Sakaguchi
河合	かわい Kawai
大山	おおやま Ooyama
多田	ただ Tada
小野寺	おのでら Onodera
宮下	みやした Miyashita
小倉	おぐら Ogura
竹田	たけだ Takeda
足立	あだち Adachi
小笠原	おがさわら Ogasawara
天野	あまの Amano
村山	むらやま Murayama
坂井	さかい Sakai
西	にし Nishi
杉浦	すぎうら Sugiura
坂田	さかた Sakata
小原	おはら Ohara
豊田	とよだ Toyoda
河村	かわむら Kawamura
武藤	むとう Mutou
角田	つのだ Tsunoda
水谷	みずたに Mizutani
根本	ねもと Nemoto
関根	せきね Sekine
森下	もりした Morishita
中井	なかい Nakai
神田	かんだ Kanda (in Tokyo)
田島	たじま Tajima
植田	うえだ Ueda
塚本	つかもと Tsukamoto
佐久間	さくま Sakuma
飯塚	いいづか Iidzuka
前川	まえかわ Maekawa
安部	あべ Abe
浅井	あさい Asai
山根	やまね Yamane
白井	しらい Shirai
宮川	みやかわ Miyakawa
岡部	おかべ Okabe
大沢	おおさわ Oosawa
大川	おおかわ Ookawa
長田	ながた Nagata
堀内	ほりうち Horiuchi
稲垣	いながき Inagaki
若林	わかばやし Wakabayashi
松崎	まつざき Matsuzaki
榎本	えもと Emoto
森山	もりやま Moriyama
神谷	かみや Kamiya
中沢	なかざわ Nakazawa
江口	えぐち Eguchi
中谷	なかたに Nakatani
畠山	はたけやま Hatakeyama
谷	たに Tani
及川	おいかわ Oikawa
細川	ほそかわ Hosokawa
三上	みかみ Mikami
今野	こんの Konno
西尾	にしお Nishio
安達	あだち Adachi
田代	たしろ Tashiro
飯島	いいじま Iijima
石塚	いしづか Ishidzuka
津田	つだ Tsuda
岸本	きしもと Kishimoto
荒川	あらかわ Arakawa
中原	なかはら Nakahara
長尾	ながお Nagao
土井	どい Doi
本多	ほんだ Honda
森川	もりかわ Morikawa
三好	みよし Miyoshi
戸田	とだ Toda
金井	かない Kanai
米田	こめだ Komeda