杉本	すぎもと Sugimoto
大西	おおにし Oonishi
桜井	さくらい Sakurai
古川	ふるかわ Furukawa
市川	いちかわ Ichikawa
島田	しまだ Shimada
小松	こまつ Komatsu
高野	たかの Takano
水野	みずの Mizuno
吉川	よしかわ Yoshikawa
山内	やまうち Yamauchi
西田	にしだ Nishida
菊池	きくち Kikuchi
西川	にしかわ Nishikawa
北村	きたむら Kitamura
浜田	はまだ Hamada
五十嵐	いがらし Igarashi
安田	やすだ Yasuda
中田	なかた Nakata
川口	かわぐち Kawaguchi
平田	ひらた Hirata
川崎	かわさき Kawasaki
東	あずま Azuma
飯田	いいだ Iida
本田	ほんだ Honda
久保田	くぼた Kubota
吉村	よしむら Yoshimura
辻	つじ Tsuji
関	せき Seki
中西	なかにし Nakanishi
福島	ふくしま Fukushima
岩田	いわた Iwata
服部	はっとり Hattori
樋口	ひぐち Higuchi
川上	かわかみ Kawakami
松岡	まつおか Matsuoka
永井	ながい Nagai
山中	やまなか Yamanaka
田口	たぐち Taguchi
森本	もりもと Morimoto
矢野	やの Yano
秋山	あきやま Akiyama
土屋	つちや Tsuchiya
石原	いしはら Ishihara
松下	まつした Matsushita
馬場	ばば Baba
大橋	おおはし Oohashi
吉岡	よしおか Yoshioka
松浦	まつうら Matsuura
小池	こいけ Koike
浅野	あさの Asano
大久保	おおくぼ Ookubo
熊谷	くまがい Kumagai
荒木	あらき Araki
野田	のだ Noda
川村	かわむら Kawamura
星野	ほしの Hoshino
広瀬	ひろせ Hirose
大谷	おおたに Ootani
黒田	くろだ Kuroda
尾崎	おざき Ozaki
田辺	たなべ Tanabe
永田	ながた Nagata
松村	まつむら Matsumura
望月	もちづき Mochidzuki
堀	ほり Hori
内藤	ないとう Naitou
菅野	かんの Kanno
西山	にしやま Nishiyama
大島	おおしま Ooshima
平井	ひらい Hirai
岩本	いわもと Iwamoto
片山	かたやま Katayama
沢田	さわだ Sawada
本間	ほんま Honma
早川	はやかわ Hayakawa
横田	よこた Yokota
荒井	あらい Arai
岡崎	おかざき Okazaki
鎌田	かまた Kamata
大石	おおいし Ooishi
成田	なりた Narita
小田	おだ Oda
宮田	みやた Miyata
石橋	いしばし Ishibashi
須藤	すどう Sudou
篠原	しのはら Shinohara
萩原	はぎわら Hagiwara
高山	たかやま Takayama
小西	こにし Konishi
栗原	くりはら Kurihara
松原	まつばら Matsubara
伊東	いとう Itou
三宅	みやけ Miyake
福井	ふくい Fukui
小沢	おざわ Ozawa
南	みなみ Minami
大森	おおもり Oomori
奥村	おくむら Okumura
片岡	かたおか Kataoka