千代田区	ちよだく	Chiyoda
中央区	ちゅうおうく	Chūō
港区	みなとく	Minato
新宿区	しんじゅくく	Shinjuku
文京区	ぶんきょうく	Bunkyō
台東区	たいとうく	Taitō
墨田区	すみだく	Sumida
江東区	こうとうく	Kōtō
品川区	しながわく	Shinagawa
目黒区	めぐろく	Meguro
大田区	おおたく	Ōta
世田谷区	せたがやく	Setagaya
渋谷区	しぶやく	Shibuya
中野区	なかのく	Nakano
杉並区	すぎなみく	Suginami
豊島区	としまく	Toshima
北区	きたく	Kita
荒川区	あらかわく	Arakawa
板橋区	いたばしく	Itabashi
練馬区	ねりまく	Nerima
足立区	あだちく	Adachi
葛飾区	かつしかく	Katsushika
江戸川区	えどがわく	Edogawa