和光市	わこうし
地下鉄成増	ちかてつなります
地下鉄赤塚	ちかてつあかつか
平和台	へいわだい
氷川台	ひかわだい
小竹向原	こたけむかいはら
千川	せんかわ
要町	かなめちょう
池袋	いけぶくろ
東池袋	ひがしいけぶくろ
護国寺	ごこくじ
江戸川橋	えどがわばし
飯田橋	いいだばし
市ケ谷	いちがや
麹町	こうじまち
永田町	ながたちょう
桜田門	さくらだもん
有楽町	ゆうらくちょう
銀座一丁目	ぎんざいっちょうめ
新富町	しんとみちょう
月島	つきしま
豊洲	とよす
辰巳	たつみ
新木場	しんきば