読み方	日本語	英語
はな	鼻	nose
だまる	黙る	become silent, shut one's mouth
こくばん	黒板	blackboard
くろじ	黒字	the black, surplus
くろい	黒い	black, dark
くろ	黒	black
きいろい	黄色い	yellow
きいろ	黄色	yellow
むぎ	麦	wheat
にわとり	鶏	chicken, hen
なる	鳴る	sound, ring, roar
ならす	鳴らす	ring, sound
なく	鳴く	cry, chirp, meow
はと	鳩	pigeon, dove
とり	鳥	bird, poultry
あざやか	鮮やか	vivid
さかな	魚	fish
みりょく	魅力	charm, attraction
かみのけ	髪の毛	hair
かみ	髪	hair, hairstyle
こうれい	高齢	advanced age, elderly
こうそくどうろ	高速道路	freeway, highway
こうそく	高速	high speed
こうきゅう	高級	high rank, high class
こうとうがっこう	高等学校	senior high school
こうとう	高等	higher, high-grade
こうおん	高温	high temperature
こうきあつ	高気圧	high pressure
こうこうせい	高校生	high school student
こうこう	高校	high school
こうど	高度	high degree
こうそう	高層	high altitude, high-rise
こうげん	高原	plateau, highland
こうか	高価	high-priced
たかめる	高める	raise, enhance
たかまる	高まる	rise, increase
たかさ	高さ	height
たかい	高い	high, tall
こっせつ	骨折	fracture, broken bone
ほね	骨	bone, frame, spirit
おどろく	驚く	be surprised, be startled
おどろき	驚き	surprise, amazement
おどろかす	驚かす	surprise, amaze
だます	騙す	deceive, cheat
そうおん	騒音	noise
そうどう	騒動	disturbance, confusion
さわぐ	騒ぐ	make a racket, mess around, make a fuss
さわぎ	騒ぎ	clamor, commotion
さわがしい	騒がしい	noisy
そうぞうしい	騒々しい	noisy, rowdy
ちゅうしゃじょう	駐車場	parking area
ちゅうしゃ	駐車	parking
かけあし	駆け足	gallop, run
かける	駆ける	gallop, run quickly
えきちょう	駅長	stationmaster
えきいん	駅員	station employee
えきまえ	駅前	in front of the station
えき	駅	railway station
だめ	駄目	no good
ばか	馬鹿	fool, nonsense
うま	馬	horse
こうすい	香水	perfume
かおり	香り	perfume, fragrance
しゅと	首都	capital
しゅのう	首脳	head, leader
しゅしょう	首相	prime minister
くび	首	neck
えさ	餌	bait, feed
やしなう	養う	foster, support
もち	餅	rice cake
かざる	飾る	decorate, exhibit
かざり	飾り	ornament, decoration
あきる	飽きる	be fed up
かう	飼う	raise, keep
あめ	飴	candy, sweets
いんりょうすい	飲料水	drinking water
のむ	飲む	drink
のみこむ	飲み込む	swallow, grasp
のみもの	飲み物	beverage, drink
のみみず	飲み水	drinking water
めし	飯	cooked rice, meal
しょくひ	食費	food expenses, board
しょくもつ	食物	food
しょくよく	食欲	appetite
しょくりょう	食料	food supplies
しょくどう	食堂	dining hall, restaurant
しょっき	食器	tableware, dinner set
しょくひん	食品	food, foodstuff
しょくたく	食卓	dining table
しょくじ	食事	meal, dinner
たべもの	食べ物	food
たべる	食べる	eat
しょくぱん	食パン	bread, loaf of bread
くう	食う	eat, live on
ひこうき	飛行機	airplane
ひこうじょう	飛行場	airport, airfield
ひこう	飛行	flight, aviation
とぶ	飛ぶ	fly
とびこむ	飛び込む	dive into
とびだす	飛び出す	fly out, dash out
とびおりる	飛び下りる	jump off, jump down
とびあがる	飛び上がる	fly up, jump up
とばす	飛ばす	fly, shoot
かぜぐすり	風邪薬	remedy for a cold
かぜ	風邪	cold (illness)
ふうせん	風船	balloon
ふうけい	風景	scenery, landscape
ふろや	風呂屋	bathhouse, public bath
ふろば	風呂場	bathroom
ふろ	風呂	bath
かぜ	風	wind
がんしょ	願書	application form
ねがう	願う	wish, ask a favor, apply for
ねがい	願い	wish, request
かおいろ	顔色	complexion, countenance
かおつき	顔付き	face, expression
かお	顔	face
あご	顎	jaw, chin
がく	額	picture frame
ひたい	額	forehead, brow
だいめい	題名	title
だい	題	title, topic
たよる	頼る	rely on, depend on
たのもしい	頼もしい	reliable, dependable
たのむ	頼む	ask, request
たのみ	頼み	request, favor
しきりに	頻りに	frequently, repeatedly
ずつう	頭痛	headache
あたま	頭	head
かしら	頭	head, chief
ほお	頬	cheek
りょういき	領域	territory, domain
りょうど	領土	territory, domain
りょうしゅうしょ	領収書	receipt, voucher
りょうじかん	領事館	consulate
がんばる	頑張る	persist, be tenacious
がんこ	頑固	stubborn, obstinate
がんじょう	頑丈	solid, strong
よきん	預金	deposit, bank account
あずける	預ける	deposit, entrust
あずかる	預かる	receive on deposit, take charge of
じゅんちょう	順調	favorable condition, smooth progress
じゅんばん	順番	order, turn
じゅんじょ	順序	order
じゅんい	順位	order, rank
じゅんじゅんに	順々に	by turns, in order
じゅん	順	order, sequence
こうもく	項目	item, clause
ころ	頃	time
ちょうだい	頂戴	getting, receiving
ちょうじょう	頂上	summit, climax
いただく	頂く	receive, eat
ひびく	響く	reverberate, vibrate
おんよみ	音読み	Chinese-derived kanji reading
おんがく	音楽	music
おと	音	sound, noise
おと	音	sound, speech sound, Chinese pronunciation of a character
ね	音	sound, note
かばん	鞄	bag, handbag, briefcase
くつした	靴下	socks, stockings
くつ	靴	shoes, boots
かくめい	革命	revolution
かわ	革	leather
めんせき	面積	area, square measure
おもしろい	面白い	interesting, amusing
めんせつ	面接	interview
めんどうくさい	面倒臭い	troublesome, tiresome
めんどう	面倒	troublesome, difficult
めんする	面する	face
めん	面	surface, aspect
ひなん	非難	criticism, blame
ひじょうしき	非常識	lack of common sense
ひじょうぐち	非常口	emergency exit
ひじょうに	非常に	very, extremely
ひじょう	非常	emergency, calamity
しずまる	静まる	become quiet, calm down
しずか	静か	quiet, tranquil
あおぞら	青空	blue sky
あおじろい	青白い	pale, pallid
せいしゅん	青春	youth
せいねん	青年	youth, young man
あおい	青い	blue
あお	青	blue, green, green light
つゆ	露	dew, dewdrop
きり	霧	fog, mist
しも	霜	frost
しんど	震度	seismic intensity
ふるえる	震える	tremble, quiver, shake
じゅよう	需要	demand
でんしゃ	電車	train
でんわちょう	電話帳	telephone book
でんわ	電話	telephone, phone call
でんせん	電線	electric wire
でんきゅう	電球	light bulb
でんとう	電灯	lamp, electric light
でんち	電池	electric cell, battery
でんき	電気	electricity, electric light
でんし	電子	electron, electronic
でんぽう	電報	telegram
でんたく	電卓	pocket calculator
でんりょく	電力	electric power, electricity
かみなり	雷	thunder, lightning
れいか	零下	below zero, sub-zero
れい	零	zero, naught
くも	雲	cloud
ふんいき	雰囲気	atmosphere, mood
ゆき	雪	snow, snowfall
あめふり	雨降り	rainfall, rainy weather
うてん	雨天	rainy weather
あまぐ	雨具	rain gear, rainwear
あめ	雨	rain
むずかしい	難しい	difficult
りりく	離陸	takeoff
りこん	離婚	divorce
はなれる	離れる	separate, leave
はなす	離す	separate, detach
ひなまつり	雛祭り	Doll Festival
ざつおん	雑音	noise, interference
ざつだん	雑談	chat, idle talk
ざっし	雑誌	magazine, journal
めす	雌	female
こよう	雇用	employment
やとう	雇う	employ, hire
しゅうだん	集団	group, mass
しゅうごう	集合	gathering, assembly
しゅうちゅう	集中	concentration, convergence
あつめる	集める	collect, gather
あつまる	集まる	gather, be collected
あつまり	集まり	gathering, assembly
ゆうだい	雄大	grand, magnificent
おす	雄	male
すずめ	雀	sparrow
となりあう	隣り合う	adjoin, be next door to each other
となり	隣	neighboring house, next seat
かくれる	隠れる	hide, disappear
かくす	隠す	hide, conceal
しょうがい	障害	obstacle, disorder
しょうじ	障子	paper sliding-door
さい	際	occasion, time
ずいぶん	随分	extremely, considerably
かいだん	階段	steps, flight of stairs
すみ	隅	nook, corner
ようき	陽気	cheerful, bright
けわしい	険しい	steep, craggy
りくじょう	陸上	land, shore
りく	陸	land, shore
おか	陸	land, shore
かげ	陰	shade, behind the scenes
のぞく	除く	rid of, exclude
げんかい	限界	boundary, limit
げんど	限度	limit, bounds
かぎる	限る	be limited to
かぎり	限り	limit, as far as possible
おろす	降ろす	unload, set down
ふる	降る	fall, come down
おりる	降りる	get off, land
ぼうえい	防衛	defense, protection
ぼうか	防火	fire prevention, fireproof
ぼうし	防止	prevention, determent
ふせぐ	防ぐ	prevent, defend
たたかう	闘う	fight
かんれん	関連	connection, relation
かんせつ	関節	joint
かんしん	関心	concern, interest
かんけい	関係	relation, relationship
かかわる	関わる	involve, concern
かんする	関する	concern, relate to
かんかく	間隔	interval, space
まちがえる	間違える	mistake, confuse
まちがう	間違う	be mistaken, be incorrect
まちがい	間違い	mistake, error
まぢか	間近	nearby, close at hand
かんせつ	間接	indirect
まもなく	間も無く	soon, in a short time
まにあわせる	間に合わせる	make do
まにあう	間に合う	be in time, answer the purpose, can do without
あいだ	間	interval
ま	間	interval, duration of time, chamber
かん	間	interval, duration of time
かいはつ	開発	development
かいほう	開放	opening
かいてん	開店	opening of a store, setting up
かいし	開始	beginning
かいさい	開催	holding (of an event), opening
かいかい	開会	opening, start a meeting
あける	開ける	open, unlock
ひらける	開ける	widen, develop
あく	開く	open
ひらく	開く	open
あき	開き	gap, vacancy
へいてん	閉店	shop closing
へいかい	閉会	closing, adjournment
しめる	閉める	shut, close
しまる	閉まる	be shut, be closed
とじる	閉じる	close
もん	門	gate, entrance
ながばなし	長話	long conversation, talk for a long time
ながそで	長袖	clothes with long sleeves
ながつづき	長続き	lasting for a long time
ちょうなん	長男	eldest son
ながいき	長生き	long life, longevity
ちょうき	長期	long period
ちょうほうけい	長方形	rectangle
ながもち	長持ち	endurance, lasting long
ちょうしょ	長所	strong point, merit
ながびく	長引く	be prolonged, drag on
ながねん	長年	many years, long time
ちょうじょ	長女	eldest daughter
ながらく	長らく	for a long time
ながさ	長さ	length
ながい	長い	long
かんしょう	鑑賞	viewing, enjoyment (of art)
かね	鐘	bell, gong
かがみ	鏡	mirror
くさり	鎖	chain, tether
かぎ	鍵	key, lock
なべ	鍋	pan, saucepan
ろくおんテープ	録音テープ	tape
ろくおん	録音	sound recording
ろくが	録画	videotaping
さびる	錆びる	rust, get rusty
するどい	鋭い	pointed, acute
はさみ	鋏	scissors, pincers, tongs
せんとう	銭湯	public bath, bathhouse
どう	銅	copper
ぎんこう	銀行	bank
ぎん	銀	silver
えんぴつ	鉛筆	pencil
てつどう	鉄道	railway
てつ	鉄	iron
どんかん	鈍感	thick-headedness
にぶい	鈍い	dull, sluggish
つる	釣る	angle, fish
つりあう	釣り合う	balance, match
つりあい	釣り合い	balance, proportion
つり	釣り	angling
はり	針	needle, needle-shaped object
くぎ	釘	nail, spike
きんがく	金額	amount of money, sum
きんせん	金銭	money, cash
きんゆう	金融	finance
きんいろ	金色	golden color
きんようび	金曜日	Friday
かねもち	金持ち	wealthy person
きんこ	金庫	strong box, safe
きんぞく	金属	metal
きんり	金利	interest, interest rate
かねもうけ	金もうけ	making money
かね	金	money
きん	金	gold, sum of money, Friday
はかる	量る	measure, weigh
りょう	量	quantity, volume
やさい	野菜	vegetable
やきゅう	野球	baseball
のはら	野原	field, plain
やとう	野党	opposition party
じゅうりょう	重量	weight
じゅうし	重視	importance, value
じゅうよう	重要	important, essential
じゅうてん	重点	important point, emphasis
じゅうやく	重役	executive
じゅうだい	重大	important, serious
おもみ	重み	weight, importance
かさねる	重ねる	pile up, repeat
かさなる	重なる	be piled up, come one after another
おもたい	重たい	heavy
おもさ	重さ	weight
おもい	重い	heavy
しょうゆ	醤油	soy sauce
みにくい	醜い	ugly, bad-looking
さんそ	酸素	oxygen
すっぱい	酸っぱい	sour
す	酢	vinegar
よっぱらう	酔っ払う	get drunk
よっぱらい	酔っ払い	drunkard, boozer
よう	酔う	get drunk
さかや	酒屋	liquor store
さけ	酒	alcoholic drink, Japanese rice wine
はいたつ	配達	delivery
くばる	配る	hand out, distribute, allot
とりつ	都立	metropolitan, Tokyo metropolitan
としん	都心	heart of a city
とちょう	都庁	Tokyo Metropolitan City Hall
とし	都市	cities, urban community
つごう	都合	circumstances
とない	都内	in the metropolitan area of Tokyo
とかい	都会	city, town
と	都	metropolis of Tokyo
みやこ	都	capital, city
ゆうそう	郵送	mailing
ゆうびんやさん	郵便屋さん	mailman
ゆうびんきょく	郵便局	post office
ゆうびん	郵便	mail service, postal matter
ぶもん	部門	division, department
ぶちょう	部長	section chief, department head
へや	部屋	room
ぶひん	部品	parts, accessories
ぶぶん	部分	part, section
ぶか	部下	subordinate
ぐん	郡	county
こうがい	郊外	suburbs, outskirts
じゃま	邪魔	disturbing
じゃま	邪魔	hindrance, obstruction
ひなん	避難	refuge, shelter
さける	避ける	avoid, evade
せんきょ	選挙	election
せんたく	選択	selection, choice
せんしゅ	選手	representative athlete
えらぶ	選ぶ	choose, elect
あう	遭う	meet with, encounter
てきよう	適用	application
てきおう	適応	adaptation, adjustment
てきとう	適当	suitable, appropriate
てきど	適度	moderate, proper
てきせつ	適切	appropriate, adequate
てきする	適する	suit, be suitable
はるか	遥か	far, distant
えんそく	遠足	excursion, hike
えんりょ	遠慮	reserve, hesitation, forethought
とおく	遠く	great distance
とおい	遠い	far, distant
いはん	違反	violation, breach
ちがう	違う	differ, be wrong
ちがいない	違いない	no mistaking it, for certain
ちがい	違い	difference, mistake
たっせい	達成	attain, achieve
たっする	達する	attain, reach
みちじゅん	道順	route, itinerary
どうろ	道路	road, street
どうとく	道徳	morality, morals
どうぐ	道具	tool
みち	道	road, street
かてい	過程	process, course
かこ	過去	the past
かろう	過労	overwork
あやまち	過ち	fault, mistake
すごす	過ごす	pass, let pass
すぎる	過ぎる	pass by, exceed
うんそう	運送	shipping, transportation
うんてんしゅ	運転手	driver
うんてん	運転	drive
うんちん	運賃	passenger fare
うんよう	運用	operation, management
うんえい	運営	operation, management
うんめい	運命	fate, fortune
うんどうじょう	運動場	playground, sports field
うんどうじょう	運動場	playground, sports field
うんどうかい	運動会	sports festival, athletic meet
うんどう	運動	movement, exercise
はこぶ	運ぶ	carry, transport
うん	運	fortune, fate
ゆうえんち	遊園地	amusement park
あそぶ	遊ぶ	play
あそび	遊び	play, amusement
ちこく	遅刻	tardiness, lateness
おくれる	遅れる	be late
おくれ	遅れ	delay, being late
おくらす	遅らす	delay, put off
おそい	遅い	slow, late
とげる	遂げる	accomplish, achieve
しんろ	進路	course, route
しんこう	進行	advancement
しんぽ	進歩	progress, advancement
しんがく	進学	entering a school of higher grade
しんしゅつ	進出	advancement
すすめる	進める	advance, promote
すすむ	進む	advance, move forward
しゅうまつ	週末	weekend
しゅうかんし	週刊誌	weekly magazine
しゅうかん	週刊	published weekly
しゅうきゅう	週休	weekend
しゅう	週	week
たいほ	逮捕	arrest, capture
れんぞく	連続	continuation, succession
れんらく	連絡	connection, communication
れんじつ	連日	day after day, everyday
れんきゅう	連休	consecutive holidays
つれる	連れる	take along, bring along
つれていく	連れて行く	take (a person) along
つれてくる	連れて来る	bring (a person)
つれ	連れ	companion
あう	逢う	meet
そくたつびん	速達便	special delivery, express mail
そくたつ	速達	special delivery, express mail
そくど	速度	speed, velocity
はやさ	速さ	speed
はやい	速い	fast
つうか	通過	passing, passage
つうろ	通路	passage, alley
つうやく	通訳	interpreting
つうこうどめ	通行止め	road closed
つうこう	通行	passage, traffic
つうち	通知	notification
つうじょう	通常	common, ordinary
つうちょう	通帳	bankbook, passbook
つうがく	通学	attending school, going to school
つうきん	通勤	commuting, commutation
つうしん	通信	correspondence, communication
とおる	通る	pass, take, go through
とおりすぎる	通り過ぎる	go past, pass
とおりかかる	通り掛かる	happen to pass by
とおり	通り	passage, street
とおす	通す	let pass, run through
つうじる	通じる	pass, communicate with
かよう	通う	go to and from, frequent a place
とちゅう	途中	on the way, half way
とうめい	透明	transparent
すきとおる	透き通る	be transparent
さからう	逆らう	disobey, go against
さかさま	逆さま	upside-down, reverse
さかさ	逆さ	reverse, inversion
ぎゃく	逆	reverse, inverse
にげみち	逃げ道	escape route
にげだす	逃げ出す	make a break for, run off
にげる	逃げる	escape, run away
にがす	逃がす	let go
そうきん	送金	money transfer, remittance
そうべつかい	送別会	farewell party
そうべつ	送別	farewell, send-off
おくる	送る	send
おくりがな	送り仮名	kana suffix
たいいん	退院	discharge from a hospital
たいしょく	退職	retirement, resignation
たいくつ	退屈	boring, tedious
たいがく	退学	withdrawal from school
ついせき	追跡	pursuit, chase
ついとつ	追突	collision
ついほう	追放	banishment, deportation
ついか	追加	addition
ついしん	追伸	P.S.
おう	追う	chase, pursue
おいこす	追い越す	outrun, overtake
おいかける	追い掛ける	chase, run after
おいぬく	追い抜く	pass, overtake
おいだす	追い出す	turn out, kick out
おいつく	追い付く	overtake, catch up with
めいわく	迷惑	trouble, annoyance
まいご	迷子	lost child, lost person
めいしん	迷信	superstition
まよう	迷う	be perplexed, hesitate, get lost
のべる	述べる	state orally, expound, mention
せまる	迫る	press, close in on, be imminent
へんきゃく	返却	return
へんじ	返事	answer, reply
かえる	返る	be restored to, return to
かえす	返す	return, repay
ちかごろ	近頃	recently, nowadays
きんこう	近郊	suburbs, outskirts
ちかみち	近道	shortcut
きんし	近視	nearsightedness, shortsightedness
きんがん	近眼	nearsightedness, shortsightedness
きんじょ	近所	neighborhood
ちかよる	近寄る	go near, approach
きんだい	近代	modern times
ちかづける	近付ける	bring close
ちかづく	近付く	approach, get acquainted
ちかく	近く	near, close to
ちかく	近く	vicinity, nearby
ちかい	近い	near, soon
むかえる	迎える	welcome, go out to meet, invite
むかえ	迎え	greeting, meeting
こめる	込める	put in, concentrate on
あたり	辺り	vicinity, around
へん	辺	vicinity, part
のうみん	農民	peasants, farmers
のうぎょう	農業	agriculture
のうそん	農村	farm village, agricultural community
のうか	農家	farmhouse
じしょ	辞書	dictionary
じてん	辞典	dictionary
じにん	辞任	resignation
やめる	辞める	resign, retire
からい	辛い	spicy, salty
からい	辛い	strict, severe
つらい	辛い	difficult, harsh
ゆそう	輸送	transport, ship
ゆしゅつ	輸出	export
ゆにゅう	輸入	import
かがやく	輝く	shine brilliantly, glitter
のる	載る	appear in print
のせる	載せる	place, put on
けいべつ	軽蔑	contempt, disdain
けいそつ	軽率	rash, light-headed
けいかい	軽快	light, cheerful
かるい	軽い	light, light weight
じく	軸	axis
てんきん	転勤	transfer
ころぶ	転ぶ	tumble down, fall over
ころがる	転がる	roll over, tumble
ころがす	転がす	roll, roll over
ぐんたい	軍隊	army, troops
ぐんじ	軍事	military affairs
ぐん	軍	army, troops
しゃどう	車道	road, roadway
しゃりん	車輪	wheel
くるまいす	車椅子	wheelchair
しゃしょう	車掌	train conductor
しゃこ	車庫	car shed, garage
しゃない	車内	inside a vehicle
くるま	車	car, automobile
くるま	車	car
しんちょう	身長	stature, height
みぢか	身近	near oneself, close to one
みぶり	身振り	gesture, gesticulation
みのまわり	身の回り	one's person, one's appearance
みなり	身なり	dress, one's appearance
み	身	body, one's own person
ける	蹴る	kick
ふみきり	踏切	railroad crossing
ふむ	踏む	step on, tread on
おどる	踊る	dance
おどり	踊り	dance, dancing
はねる	跳ねる	leap, hop, bound
あと	跡	trace, track
きょり	距離	distance, interval
あしくび	足首	ankle
あしおと	足音	sound of footsteps
あしあと	足跡	footprint, footmark
あしもと	足下	step, under foot
たりる	足りる	suffice, serve, be satisfied
たす	足す	add, supplement
たしざん	足し算	addition
あし	足	leg, foot
しゅみ	趣味	hobby, interest
こす	越す	go over, surmount
こえる	越える	go over, go across, go beyond
ちょうか	超過	excess
きげん	起源	origin, beginning
おこる	起こる	happen
おこす	起こす	wake up
おこす	起こす	bring about, cause
おきあがる	起き上がる	get up, rise
おきる	起きる	get up, get out of bed
おきる	起きる	occur
はしる	走る	run
せきどう	赤道	equator
あかじ	赤字	deficit, in the red
あかんぼう	赤ん坊	baby
あかちゃん	赤ちゃん	baby
あかい	赤い	red
あか	赤	red, crimson
おくる	贈る	offer, give
おくりもの	贈り物	present, gift
こうにゅう	購入	purchase
かける	賭ける	bet, stake
しつもん	質問	question
しつ	質	quality, nature
かしこい	賢い	wise, smart
しょうひん	賞品	prize, trophy
しょう	賞	prize, award
さんせい	賛成	approval, agreement
にぎわう	賑わう	bustle, enliven
にぎやか	賑やか	lively, exciting
しきん	資金	funds, capital
しさん	資産	property, assets
しげん	資源	resources
しかく	資格	qualifications, competence
しほんしゅぎ	資本主義	capitalism
しりょう	資料	materials, data
ぼうえき	貿易	trade, commerce
はる	貼る	stick, paste
ひよう	費用	expenses
ついやす	費やす	expend, waste
かす	貸す	lend, lease
かしだす	貸し出す	lend, lend out
かしだし	貸し出し	lending service, checking out
かし	貸し	loan, renting
ばいしゅう	買収	buying up, bribing
かう	買う	buy
かいもの	買い物	shopping, purchase
きちょうひん	貴重品	article of value, valuables
きちょう	貴重	precious, valuable
とうとい	貴い	precious, valuable
ちょきん	貯金	savings, deposit
せきにん	責任	responsibility, liability
はんばい	販売	sale, selling
かもつ	貨物	freight, cargo
かへい	貨幣	money, currency
びんぼうにん	貧乏人	poor person, the poor
びんぼう	貧乏	poverty, destitution
まずしい	貧しい	poor, needy
ざいさん	財産	fortune, asset
ざいせい	財政	public finance, financial affairs
さいふ	財布	purse, wallet
ふたん	負担	burden, charge
ふしょう	負傷	hurt, injury
まける	負ける	lose
まけ	負け	defeat, loss
かい	貝	shellfish, shell
しょうちょう	象徴	symbol, symbolize
ぞう	象	elephant
ぶたにく	豚肉	pork, hog meat
ぶた	豚	pig, pork
ほうふ	豊富	abundant, plentiful
ゆたか	豊か	abundant, ample
とうふ	豆腐	tofu
まめ	豆	bean, peas
たに	谷	valley, ravine
ゆずる	譲る	transfer, concede
ぎだい	議題	topic for discussion, agenda
ぎちょう	議長	chairman, president
ぎろん	議論	argument, discussion
ぎいん	議員	legislator
ぎかい	議会	assembly, council
けいかい	警戒	vigilance, precaution
けいさつ	警察	police
けいかん	警官	police officer, policeman
けいこく	警告	warning, admonition
あやまる	謝る	apologize
こうぎ	講義	lecture
こうえん	講演	lecture
こうし	講師	speaker, lecturer
こうどう	講堂	lecture hall, auditorium
けんそん	謙遜	humility, modesty
なぞ	謎	puzzle, mystery
しょこく	諸国	various countries
あきらめる	諦める	abandon, give up
ろんりてき	論理的	logical
ろんり	論理	logic
ろんぶん	論文	thesis, paper
ろんじる	論じる	argue, discuss
ろん	論	argument, opinion
ちょうせつ	調節	adjustment, regulation
ちょうさ	調査	investigation, inquiry
ちょうせい	調整	regulation, adjustment
ちょうし	調子	tone, condition
ちょうわ	調和	harmony, agreement
ちょうみりょう	調味料	seasoning, flavoring
しらべる	調べる	investigate, check
しらべ	調べ	investigation, inquiry
かだい	課題	task, problem
かちょう	課長	section chief
かてい	課程	course, curriculum
か	課	section, division, lesson
だれか	誰か	someone
だれ	誰	who, whom
どくしゃ	読者	reader, subscriber
どくしょ	読書	reading a book
よむ	読む	read
よみかき	読み書き	reading and writing
よみかた	読み方	way of reading, reading
よみ	読み	reading, judgment, foresight
せつめい	説明	explanation, description
せっとく	説得	persuasion
とく	説く	explain, preach
せつ	説	theory, opinion
ごかい	誤解	misunderstanding
あやまる	誤る	make a mistake
あやまり	誤り	error, mistake
せいじつ	誠実	sincerity, honesty
まことに	誠に	truly, very
ごがく	語学	language study
かたる	語る	tell, talk
さそう	誘う	invite, ask out
たんじょうび	誕生日	birthday
たんじょう	誕生	birth
ちかう	誓う	vow, swear
にんしき	認識	recognition, acknowledgment
にんか	認可	approval, authorization
みとめる	認める	recognize, acknowledge
しょうさい	詳細	details, particulars
くわしい	詳しい	detailed, complete
わだい	話題	topic of conversation
はなす	話す	speak, tell
はなしことば	話し言葉	spoken language
はなしかける	話し掛ける	address someone, speak to someone
はなしごえ	話し声	voice, whisper
はなしあう	話し合う	discuss, talk over
はなしあい	話し合い	talk, discussion
はなし	話	talk, story
つめる	詰める	stuff, fill
つまる	詰まる	be stuffed, be stopped up
わびる	詫びる	apologize
しじん	詩人	poet
し	詩	poetry
しけん	試験	test, examination
しあい	試合	match, game
こころみる	試みる	try, attempt
ためす	試す	try, test
ためし	試し	trial, test
ひょうばん	評判	fame, reputation
ひょうか	評価	evaluation, appraisal
しょうめい	証明	proof, evidence
しょうこ	証拠	proof, evidence
しょうけん	証券	bill, bond
しんだん	診断	diagnosis
しんさつ	診察	medical examination
みる	診る	examine
うったえる	訴える	sue
うったえ	訴え	lawsuit, appeal
やくす	訳す	translate
わけ	訳	reason, cause
やく	訳	translation, rendering
きょか	許可	permission, approval
ゆるす	許す	permit, license, forgive
せっけい	設計	design, plan
せっち	設置	establishment
せつりつ	設立	establishment, foundation
せつび	設備	equipment, facilities
もうける	設ける	set up, establish
ほうもん	訪問	visit
おとずれる	訪れる	visit, call on
たずねる	訪ねる	visit, call on
きろく	記録	record, documentation
きじゅつ	記述	description
きしゃ	記者	journalist, reporter
きおく	記憶	memory, recollection
きねんび	記念日	memorial day, anniversary
きねん	記念	commemoration, memory
きごう	記号	symbol, mark
きにゅう	記入	entry, record
きじ	記事	article, story
くんよみ	訓読み	Japanese pronunciation
くんれん	訓練	training, drill
くん	訓	Japanese reading of kanji
とうろん	討論	debate, discussion
けいさん	計算	calculation
けいかく	計画	plan, project
はかる	計る	compute, measure
けい	計	total
ていせい	訂正	correction, amendment
げんろん	言論	speech, discussion
げんご	言語	language, speech
ことばづかい	言葉遣い	wording, language
ことば	言葉	word, language
ことづける	言付ける	leave a message
いう	言う	say, tell
いいかえす	言い返す	talk back, retort
いいわけ	言い訳	apology, excuse
いいあらわす	言い表わす	express, say
いいかた	言い方	way of speaking, expression
いいかえる	言い換える	express in different words, paraphrase
いいだす	言い出す	begin to speak
ふれる	触れる	touch, come in contact with
さわる	触る	touch, feel
かいしゃく	解釈	interpretation, explanation
かいせつ	解説	explanation, commentary
かいとう	解答	solution, answer
かいけつ	解決	solution, settlement
かいさん	解散	breakup, dissolution
かいほう	解放	release, setting free
とける	解ける	solve, resolve
とく	解く	solve
かくど	角度	angle
かど	角	corner, edge, angle
かんしょう	観賞	ornamental
かんしゅう	観衆	audience
かんそく	観測	observation
かんさつ	観察	observation, supervision
かんきゃく	観客	audience, spectator
かんこう	観光	sightseeing
しんるい	親類	relatives, kin
おやゆび	親指	thumb
しんせき	親戚	a relative
おやこ	親子	parent and child
しんぜん	親善	goodwill, friendly relations
しんゆう	親友	close friend
しんせつ	親切	kind, friendly
しんせつ	親切	kindness
したしむ	親しむ	get close to, get familiar with
したしみ	親しみ	intimacy, familiarity
したしい	親しい	intimate, familiar
おや	親	parent
かくご	覚悟	readiness, resolution
さめる	覚める	awake, wake up
さます	覚ます	awaken, wake up
おぼえる	覚える	memorize, learn
おぼえ	覚え	recollection, memory
してん	視点	viewpoint
きぼ	規模	scale, scope
きてい	規定	regulation, provision
きそく	規則	rule, regulation
きせい	規制	regulation, control
みちがえる	見違える	mistake, fail to recognize
みとおし	見通し	perspective, prospect
みおくる	見送る	see (someone) off
みおくり	見送り	seeing someone off
みこみ	見込み	hope, prospect
けんかい	見解	opinion, view
みおぼえ	見覚え	recognition, remembrance
みおとす	見落とす	miss, fail to notice
みまう	見舞う	visit someone
みまい	見舞い	personal visit
みならう	見習う	learn, follow someone's example
みなおす	見直す	reconsider, change one's opinion for the better
けんぶつにん	見物人	spectator, sightseer
けんぶつ	見物	sightseeing, visit
みわたす	見渡す	look out over
みくらべる	見比べる	look from one to another, compare
みほん	見本	sample, model
みはらし	見晴らし	view, outlook
みかた	見方	view, way of looking
けんとう	見当	estimate, aim
みまもる	見守る	watch, keep watch over
けんがく	見学	observation tour, study tour, field trip
みあい	見合い	meeting with a view to marriage
みだし	見出し	headline, heading
みごと	見事	splendid, admirable
みおろす	見下ろす	look down, overlook
みあげる	見上げる	look up
みる	見る	see, look at
みつめる	見つめる	stare
みつける	見つける	find
みつかる	見つかる	be found, be caught
みせる	見せる	show
みかけ	見かけ	looks, appearance
みえる	見える	be visible
おおう	覆う	cover, hide
ようこう	要項	important points
ようせい	要請	request, demand
ようてん	要点	main point, gist
ようきゅう	要求	requirement, demand
ようぼう	要望	demand, request
ようし	要旨	gist, overview
よういん	要因	primary factor, main cause
いる	要る	need, require
ようするに	要するに	in a word, in short
ようする	要する	require, need
せいようじん	西洋人	Westerner
せいよう	西洋	the West, the Occident
せいれき	西暦	Christian Era, A.D.
にし	西	west, western
おそう	襲う	raid, attack
えり	襟	collar, lapel
ほめる	褒める	praise, commend
ふくざつ	複雑	complicated, intricate
ふくすう	複数	plural
せいぞう	製造	production, manufacture
せいひん	製品	manufactured goods
せいさく	製作	manufacture, production
はだか	裸	naked body, bareness
おぎなう	補う	supplement, replenish
うらもん	裏門	back gate
うらがえす	裏返す	turn over, turn inside out
うらがえし	裏返し	turn over, turn inside out
うらおもて	裏表	inside-out, front and back
うらぐち	裏口	back door, kitchen door
うらぎる	裏切る	betray
うら	裏	rear, reverse, inside
そうち	装置	equipment, device
さける	裂ける	split, tear
さいばんしょ	裁判所	courthouse
さいばん	裁判	trial, judgment
ひがい	被害	damage, harm
かぶる	被る	wear, put on
かぶせる	被せる	cover
そで	袖	sleeve
ふくろ	袋	bag, sack
おとろえる	衰える	weaken, decline
ひょうめん	表面	surface, appearance
ひょうし	表紙	cover, binding
ひょうげん	表現	expression
ひょうじょう	表情	expression, look
あらわす	表す	express, represent
おもて	表	front side, face, outside
ひょう	表	table, list
いしょくじゅう	衣食住	clothing and food and housing
いるい	衣類	clothes, garments
いふく	衣服	clothes, dress
いりょう	衣料	clothing, garments
しょうとつ	衝突	collision, conflict
えいせいてき	衛生的	sanitary, hygienic
えいせい	衛生	hygiene, sanitation
えいせい	衛星	satellite, moon
こうしん	行進	march, parade
こうてい	行程	distance, journey
こうい	行為	act, conduct
こうらく	行楽	excursion, outing
ゆくえ	行方	one's whereabouts
ぎょうせい	行政	administration
こうどう	行動	action, conduct
ぎょうれつ	行列	queue, line
ぎょうぎ	行儀	manners, behavior
ぎょうじ	行事	event, function
いく	行く	go
いきどまり	行き止まり	dead end
いきき	行き来	comings and goings, communication
いき	行き	going
ゆき	行き	going
おこなう	行う	do, carry out
ぎょう	行	line, row
しゅうぎいん	衆議院	House of Representatives, Lower House
けっかん	血管	blood vessel
けつえき	血液	blood
ち	血	blood
ちょうちょう	蝶蝶	butterfly
はち	蜂	bee
けいこうとう	蛍光灯	fluorescent lamp
たんぱくしつ	蛋白質	protein
へび	蛇	snake, serpent
か	蚊	mosquito
にじ	虹	rainbow
むしば	虫歯	decayed tooth, cavity
むし	虫	insect, worm
くすりゆび	薬指	third finger, ring finger
やっきょく	薬局	drugstore, pharmacy
やくひん	薬品	medicine, drug
くすり	薬	drug, remedy, chemical
うすぎ	薄着	light clothing
うすぐらい	薄暗い	gloomy, dim
うすめる	薄める	thin, dilute
うすい	薄い	thin, weak, pale
むしあつい	蒸し暑い	humid
そうしき	葬式	funeral ceremony
ちょしゃ	著者	author, writer
ちょしょ	著書	literary work, book
あらわす	著す	write, compose
いちじるしい	著しい	remarkable, conspicuous
はがき	葉書	postcard
はっぱ	葉っぱ	leaf
は	葉	leaf, needle
らくだい	落第	failing an exam
おとす	落とす	drop, omit
おとしもの	落とし物	lost property
おちば	落ち葉	fallen leaves
おちつく	落ち着く	calm down, settle in
おちつき	落ち着き	presence of mind, composure
おちる	落ちる	fall, sink
はなやか	華やか	gorgeous, colorful
きく	菊	chrysanthemum
にもつ	荷物	baggage, load
あれる	荒れる	be wild, run waste
あらす	荒す	damage, ransack
あらい	荒い	wild, reckless
あらい	荒い	harsh, rough
くさばな	草花	plants and flowers
くさき	草木	plants and trees
くさ	草	grass, weed
ちゃいろ	茶色	light brown
ちゃわん	茶わん	tea cup, rice bowl
ちゃ	茶	tea (plain form)
くき	茎	stem
なす	茄子	eggplant
いちご	苺	strawberry
えいゆう	英雄	hero
えいご	英語	English
えいぶん	英文	English, English writing
えいわ	英和	English-Japanese
くつう	苦痛	pain, agony
にがて	苦手	person that is hard to deal with, weak point
くじょう	苦情	complaint, grievance
くしん	苦心	pains, efforts
くろう	苦労	difficulty, hardship
くるしめる	苦しめる	torment, trouble
くるしむ	苦しむ	suffer, be troubled
くるしみ	苦しみ	distress, suffering
くるしい	苦しい	painful, difficult
にがい	苦い	bitter, sour
わかもの	若者	young person, youth
わかい	若い	young
わかわかしい	若々しい	youthful, young-looking
いじめる	苛める	ill-treat, abuse
いじめ	苛め	bullying
め	芽	bud, sprout
げいじゅつ	芸術	art, arts and crafts
はなみ	花見	flower viewing
かびん	花瓶	flower vase
はなび	花火	fireworks, firecrackers
はなたば	花束	bunch of flowers
はなよめ	花嫁	bride
はなむこ	花婿	bridegroom
はな	花	flower
しばふ	芝生	lawn, turf
いも	芋	potato, yam
いろいろ	色々	in various ways
いろ	色	color
りょうしん	良心	conscience
よい	良い	good, suitable, preferable
いい	良い	good
せんちょう	船長	captain
ふなびん	船便	surface mail, shipping service
ふね	船	ship, boat, vessel
こうくうき	航空機	aircraft, airplane
こうくうけん	航空券	airline ticket
こうくうびん	航空便	airmail
こうくう	航空	aviation
ぶたい	舞台	stage, setting
した	舌	tongue
こうふん	興奮	excitement, agitation
きょうみ	興味	interest
いたす	致す	humbly do
しきゅう	至急	urgent, pressing
いたるところ	至る所	everywhere, all over
いたる	至る	come to, reach
におう	臭う	stink (unpleasant)
くさい	臭い	ill-smelling, stinking
におい	臭い	smell, odor
じてんしゃ	自転車	bicycle
じしん	自身	self
じえいたい	自衛隊	Self Defense Forces
じしゅう	自習	self-study, self-teaching
じゆう	自由	freedom
しぜんかがく	自然科学	natural science
しぜんに	自然に	naturally, instinctively
しぜん	自然	nature
しぜん	自然	natural, naturally
じすい	自炊	cooking food for oneself
じさつ	自殺	suicide
じまん	自慢	showing off
じこ	自己	oneself, self
じたく	自宅	one's house, one's home
じこく	自国	one's own country
じどうしゃ	自動車	automobile
じどう	自動	automatic operation
じぶん	自分	self, oneself
じしん	自信	self-confidence
じしゅてき	自主的	autonomous, voluntary
じしゅ	自主	independence, autonomy
みずから	自ら	oneself
りんじ	臨時	temporary, provisional
のぞむ	臨む	be present at
おくびょう	臆病	cowardice, timidity
ふくれる	膨れる	expand, fill up
ふくらむ	膨らむ	expand, swell
はらいっぱい	腹一杯	full stomach
はら	腹	belly
ちょう	腸	intestines, entrails
こしかける	腰掛ける	sit down
こしかけ	腰掛け	stool, seat
こし	腰	hip, lower back
うでどけい	腕時計	wrist watch
うで	腕	arm
くさる	腐る	rot, corrode
のう	脳	brain
だっせん	脱線	derailment
ぬぐ	脱ぐ	remove clothes, take off
おどかす	脅かす	threaten, intimidate
しぼう	脂肪	fat, grease
あぶら	脂	fat, grease
のうりつ	能率	efficiency
のうりょく	能力	ability, capacity
のう	能	noh play
のう	能	ability, capability
むね	胸	chest
はいけい	背景	background, scenery, setting
せびろ	背広	business suit
せなか	背中	back
せ	背	height, stature
いちょう	胃腸	stomach and intestines
い	胃	stomach
はい	肺	lung, lungs
いくじ	育児	childcare, child-raising
そだてる	育てる	bring up, breed
そだつ	育つ	be brought up, grow
こうてい	肯定	affirmation
かた	肩	shoulder
また	股	crotch, groin
かんじん	肝心	vital, essential
はだいろ	肌色	flesh color
はだぎ	肌着	underwear
はだ	肌	skin, surface
にくたい	肉体	body, flesh
にく	肉	flesh, meat
しょくぎょう	職業	occupation, vocation
しょくば	職場	place of work, office
しょくいん	職員	staff, employee
きこえる	聞こえる	hear, be heard
きく	聞く	hear, ask
ききて	聞き手	listener, audience
ききとり	聞き取り	listening comprehension, dictation
きかす	聞かす	tell, read aloud
じびか	耳鼻科	otorhinology, ENT
みみ	耳	ear, hearing
たえる	耐える	withstand, endure
もの	者	person, fellow
こうりょ	考慮	consideration, deliberation
かんがえる	考える	think, consider
かんがえ	考え	thought, view, idea
ろうじん	老人	old person, elderly
ほんやく	翻訳	translation
しゅうかん	習慣	custom, habit
ならう	習う	learn, practice
よくあさ	翌朝	the following morning
よくじつ	翌日	the following day
よくねん	翌年	the following year
はね	羽根	feather
ぎり	義理	sense of duty, justice
ぎむ	義務	duty, obligation
うらやましい	羨ましい	envious, envy
ぐんしゅう	群集	crowd
ぐんしゅう	群衆	the masses, multitude
むれ	群れ	crowd, herd
びじゅつかん	美術館	art museum
びじゅつ	美術	art, fine arts
びよういん	美容院	beauty shop
びじん	美人	beautiful woman
うつくしい	美しい	beautiful
ばっきん	罰金	fine, penalty
ばっする	罰する	punish
ばつ	罰	punishment, penalty
おく	置く	put, leave
つみ	罪	crime, sin
かんづめ	缶詰	canned goods, cooping-up
かん	缶	can, tin
くりかえす	繰り返す	repeat
おりもの	織物	cloth, textile
はんえい	繁栄	prosperity, thriving
しゅくしょう	縮小	reduction, curtailment
ちぢめる	縮める	contract, shorten
ちぢむ	縮む	shrink, contract
ちぢみ	縮み	shrinkage
ちぢまる	縮まる	be shortened, be contracted
ぬう	縫う	sew, stitch
たてがき	縦書き	vertical writing
たて	縦	lengthways, vertical
しばる	縛る	bind, restrict
なわ	縄	rope, cord
れんしゅう	練習	practice, training
ゆるやか	緩やか	slack, loose
ゆるめる	緩める	loosen, unloose
ゆるむ	緩む	slacken, be loose
ゆるい	緩い	slack, loose
へんしゅう	編集	editing, compilation
あむ	編む	knit
しめきる	締め切る	close, fix a deadline
しめきり	締め切り	deadline, time limit
しめる	締める	tighten, fasten
しまる	締まる	tighten, be compact
せんろ	線路	line, track
せん	線	line
みどりいろ	緑色	green
みどり	緑	green, foliage
そうさい	総裁	president, governor
そうりだいじん	総理大臣	prime minister
そうり	総理	president, prime minister
そうすう	総数	total
そうごう	総合	synthesis, integration
そうかい	総会	general meeting
きんきゅう	緊急	urgent, pressing
きんちょう	緊張	tension, strain
めん	綿	cotton
あみ	網	net, netting
つな	綱	rope, line
いじ	維持	maintenance, upkeep
つづける	続ける	continue, keep up
つづく	続く	continue, follow
つづき	続き	continuation, sequel
ぞくぞく	続々	in rapid succession, one after another
けいぞく	継続	continuation, succession
つぐ	継ぐ	succeed, inherit
きぬ	絹	silk, silk fabrics
ぜったいに	絶対に	absolutely, unconditionally
ぜったい	絶対	absolutely
たえず	絶えず	constantly, always
えはがき	絵葉書	picture postcard
えほん	絵本	picture book
え	絵	picture, painting, drawing
とうけい	統計	statistics
とうごう	統合	integration, combination
とういつ	統一	unity, coordination
きゅうりょう	給料	salary, pay
しぼる	絞る	wring out, squeeze
けつろん	結論	conclusion
けっこう	結構	quite
けっこう	結構	all right, no thank you
けっかく	結核	tuberculosis
けっか	結果	result, outcome
けっしょう	結晶	crystallization
けっせい	結成	organization, formation
けっきょく	結局	after all, finally
けっこん	結婚	marriage
けつごう	結合	combination, joining
むすぶ	結ぶ	tie, join
むすび	結び	end, close
けいけん	経験	experience
けいか	経過	progression, lapse
けいひ	経費	expense
けいゆ	経由	via, through
けいざいてき	経済的	economical, economic
けいざい	経済	economy, economics
けいれき	経歴	personal history, resume
けいえい	経営	management, operation
へる	経る	pass, pass through
たつ	経つ	pass, elapse
そしき	組織	organization, constitution, tissue
くみあい	組合	union, guild
くむ	組む	pair up, partner with
くみこむ	組み込む	incorporate, integrate
くみたてる	組み立てる	build, set up, construct
くみあわせる	組み合わせる	assort, join together
くみあわせ	組み合わせ	combination, assortment
くみ	組	school class
しゅうでん	終電	last train
しゅうてん	終点	last stop, terminus
しゅうりょう	終了	end, expiry
おわる	終わる	finish, end
おわり	終わり	end, conclusion
おえる	終える	end, finish
こん	紺	dark blue, navy blue
しょうかい	紹介	introduction, presentation
しんし	紳士	gentleman
ほそながい	細長い	long and thin, slender
こまかい	細かい	minute, elaborate
こまか	細か	minute, elaborate
ほそい	細い	thin, slender, narrow
むらさき	紫	purple
さくいん	索引	index
すなお	素直	honest, straightforward
すばらしい	素晴らしい	splendid, excellent
すばやい	素早い	nimble, quick
すてき	素敵	lovely, nice
きゅう	級	grade, class
かみくず	紙屑	wastepaper
かみ	紙	paper
じゅんすい	純粋	pure, unmixed
なっとう	納豆	natto (fermented soybeans)
なっとく	納得	acceptance, persuasion
おさめる	納める	pay a tax or fee
こうよう	紅葉	autumn leaves, crimson foliage
こうちゃ	紅茶	black tea
やくそく	約束	promise, vow
けいとう	系統	system, lineage
けいれつ	系列	affiliation
いと	糸	thread, yarn
のり	糊	glue, starch
せいさん	精算	settlement of accounts, adjustment
せいしん	精神	mind, spirit
あらすじ	粗筋	outline, plot
つぶ	粒	grain, drop
こな	粉	powder, flour
こめ	米	rice (grain)
かんたん	簡単	simple, easy
はんい	範囲	range, scope
せつやく	節約	economizing, saving
はし	箸	chopsticks
はこ	箱	box, case
かんり	管理	management, administration
かん	管	pipe, tube
さく	策	scheme, policy
とうあん	答案	examination paper, answer
こたえる	答える	answer, reply
こたえ	答え	answer, solution
すじみち	筋道	method, logic
きんにく	筋肉	muscle, sinews
すじ	筋	muscle
ひとしい	等しい	equal, same
ひっきしけん	筆記試験	written examination
ひっきようぐ	筆記用具	writing materials, pens and pencils
ひっしゃ	筆者	writer
ふで	筆	writing brush, penmanship
だいいち	第一	number one, the best
ふえ	笛	flute, whistle
えがお	笑顔	smiling face, smile
わらう	笑う	laugh, smile
わらいごえ	笑い声	laughter
わらい	笑い	laughter
たけ	竹	bamboo
きょうぎ	競技	match, sporting event
きょうそう	競争	competition
はし	端	end, edge
しょう	章	chapter
りっぱ	立派	fine, excellent
たちば	立場	standpoint, position
たてこむ	立て込む	full of, crowded with
たてかえる	立て替える	pay for another, pay in advance
たてる	立てる	stand, set up, establish
たつ	立つ	stand, rise
たちなおる	立ち直る	recover, regain one's footing
たちどまる	立ち止まる	stop, halt
たちいりきんし	立ち入り禁止	no trespassing
たちあがる	立ち上がる	stand up, take action
きゅうくつ	窮屈	tight, cramped
まどぐち	窓口	window
まど	窓	window, windowpane
とつぜん	突然	abruptly, suddenly
つっこむ	突っ込む	thrust in, dash into
つく	突く	thrust, poke
つきあたる	突き当たる	hit against, come to the end of
つきあたり	突き当たり	end of a street
くうかん	空間	space, room
くうこう	空港	airport
くうき	空気	air, atmosphere
からて	空手	karate, empty hand
くうそう	空想	fantasy, daydreams
くうちゅう	空中	in the air, in the sky
からっぽ	空っぽ	empty
あける	空ける	empty, clear out
あく	空く	become available or vacant
すく	空く	be empty
あきち	空き地	unoccupied ground, vacant lot
あき	空き	vacancy, free time
そら	空	sky, weather
から	空	emptiness, hollow
あな	穴	hole, cavity
おだやか	穏やか	calm, mild
せっきょくてき	積極的	positive, active
つもる	積もる	accumulate, get accumulated
つむ	積む	pile up, accumulate
けいこ	稽古	practice, learning
かせぐ	稼ぐ	earn, make money
いね	稲	rice plant
しゅるい	種類	kind, species
しゅもく	種目	item, event
たね	種	seed
ぜいかん	税関	custom house, customs
ぜいきん	税金	tax
ぜい	税	tax, duty
ていど	程度	degree, extent
ほど	程	extent, limit
いてん	移転	transfer, change of address
いどう	移動	movement, shift
うつる	移る	move, shift
うつす	移す	move, shift, transfer
ちつじょ	秩序	order, method
ひしょ	秘書	secretary
ひみつ	秘密	secret, privacy
かもく	科目	subject
かがくしゃ	科学者	scientist
かがく	科学	science
あきかぜ	秋風	autumn breeze
しゅうぶん	秋分	autumnal equinox
あき	秋	autumn, fall
してつ	私鉄	private railway
しひ	私費	private expense
しりつ	私立	private
しよう	私用	private business, private use
わたしたち	私たち	we
わたくし	私	I, myself
わたし	私	I
ふくし	福祉	welfare
きんしゅ	禁酒	abstention from alcohol
きんえん	禁煙	no smoking, giving up smoking
きんし	禁止	prohibition, forbiddance
きんじる	禁じる	prohibit, forbid
さいじつ	祭日	national holiday, festival day
まつり	祭り	festival
しんとう	神道	Shinto
しんけい	神経	sensitivity, nerves
じんじゃ	神社	Shinto shrine
かみさま	神様	god, the divine
かみ	神	god, spirit
しゅくじつ	祝日	holiday, festival day
いわう	祝う	celebrate, congratulate
いわい	祝い	celebration, congratulation
そふ	祖父	grandfather
そぼ	祖母	grandmother
そせん	祖先	ancestor, forefather
いのる	祈る	pray, wish for
いのり	祈り	prayer
しゃちょう	社長	president (of a company)
しゃせつ	社説	editorial
しゃいん	社員	staff member, employee
しゃかいかがく	社会科学	social sciences
しゃかいじん	社会人	member of society, working person
しゃかい	社会	society
れいぎ	礼儀	good manners, courtesy
れい	礼	bow, courtesy
しめす	示す	show, indicate
みがく	磨く	polish, grind
かくにん	確認	confirmation
かくりつ	確立	establishment
かくりつ	確率	probability, rate
かくじつ	確実	certain, secure
かくてい	確定	decision, confirmation
かくしん	確信	firm belief, conviction
かくほ	確保	securement
たしかめる	確かめる	make sure of, confirm
たしか	確か	for sure, for certain
かたさ	硬さ	hardness
はかい	破壊	breaking, destruction
やぶれる	破れる	tear, rip open
やぶる	破る	tear, break through, breach
やぶる	破る	defeat
くだける	砕ける	be crushed, break down
くだく	砕く	crush, smash
けんきゅう	研究	research, study
さとう	砂糖	sugar
さばく	砂漠	desert
すなはま	砂浜	sandy beach, sands
すな	砂	sand, grit
せっけん	石鹸	soap
せきたん	石炭	coal
せきゆ	石油	petroleum, oil
いし	石	stone, small rock
たんしゅく	短縮	shortening, contraction
たんき	短気	short temper
たんきだいがく	短期大学	junior college
たんき	短期	short-term
たんしょ	短所	shortcoming, defect
たんだい	短大	junior college
みじかい	短い	short, brief
ちしき	知識	knowledge
ちのう	知能	intelligence, mental capacity
ちてき	知的	intellectual, mental
ちじん	知人	acquaintance, friend
ちじ	知事	governor
しれる	知れる	become known, be found out
しる	知る	know
しりあう	知り合う	get acquainted with
しりあい	知り合い	acquaintance
しらせる	知らせる	let know, inform
しらせ	知らせ	information, notice
しらずしらず	知らず知らず	unawares, without knowing it
やじるし	矢印	arrow
むじゅん	矛盾	contradiction
しゅんかん	瞬間	instant, moment
すいみん	睡眠	sleep, slumber
ちゃくりく	着陸	landing
きもの	着物	clothes, kimono
きがえる	着替える	change clothes
きがえ	着替え	change of clothes
ちゃくせき	着席	taking a seat
きる	着る	wear, put on
きせる	着せる	dress, put on clothes
つける	着ける	pull up, park (a vehicle)
つく	着く	arrive, make contact, settle
めがね	眼鏡	glasses, judgment
がんか	眼科	ophthalmology
ながめる	眺める	look out, gaze
ながめ	眺め	view, prospect
ねむる	眠る	sleep
ねむり	眠り	sleep, slumber
ねむたい	眠たい	sleepy
ねむい	眠い	sleepy
まじめ	真面目	serious, sober, earnest
しんそう	真相	the truth
しんり	真理	truth
しんじゅ	真珠	pearl
まごころ	真心	sincerity, true heart
しんじつ	真実	truth, reality
まよなか	真夜中	midnight, middle of the night
まなつ	真夏	midsummer
ましかく	真四角	square
しんけん	真剣	serious, sincere
まんまる	真ん丸	perfect circle
まんなか	真ん中	center, middle
まっくろ	真っ黒	deep-black, jet-black
まっさお	真っ青	deep-blue, pale (skin)
まっか	真っ赤	deep red
まっすぐ	真っ直ぐ	dead straight, honestly
まっしろ	真っ白	pure-white
まっさいちゅう	真っ最中	midst
まっくら	真っ暗	pitch-dark
まっさき	真っ先	first thing, forefront
けんりつ	県立	prefectural
けんちょう	県庁	prefectural office
けん	県	prefecture
かんごふ	看護婦	female nurse
かんご	看護	nursing
かんびょう	看病	nursing, nursing care
かんばん	看板	signboard, sign
まゆげ	眉毛	eyebrows
まゆ	眉	eyebrow
しょうりゃく	省略	omission, abbreviation
はぶく	省く	omit, dispense with
そうだん	相談	consultation, advice
すもう	相撲	sumo wrestling
あいて	相手	opponent
ふさわしい	相応しい	suitable, appropriate
そうとう	相当	correspondence, suitability
あいかわらず	相変わらず	as usual, as before
そうば	相場	market price, speculation
そうご	相互	mutual, reciprocal
ちょくつう	直通	direct link
ちょっかく	直角	right angle
ちょくせん	直線	straight line
ちょくせつ	直接	directly
ちょくご	直後	immediately after
ちょっけい	直径	diameter
ちょくぜん	直前	just before, immediately prior
なおる	直る	be repaired, return to normal
ただちに	直ちに	at once, immediately
なおす	直す	repair, cure, alter
すぐ	直ぐ	at once, soon
めざましどけい	目覚まし時計	alarm clock
めざましい	目覚ましい	striking, marvelous
めざまし	目覚まし	waking up
めぐすり	目薬	eye drops
めちゃくちゃ	目茶苦茶	in a mess, terrible
めだつ	目立つ	stand out, be conspicuous
もくてきち	目的地	destination, goal
もくてき	目的	object, purpose
もくじ	目次	table of contents
もくひょう	目標	target, goal
めかた	目方	weight
めざす	目指す	aim for, have an eye on
めじるし	目印	landmark, sign
めした	目下	one's inferiors
もっか	目下	now, at present
めうえ	目上	one's superiors, one's elders
め	目	eye
かんとく	監督	supervisor, film director
さかん	盛ん	prosperous, active
もる	盛る	heap up, fill
もりあげる	盛り上げる	build up excitement
もりあがる	盛り上がる	become lively, get fired up
とうなん	盗難	robbery, burglary
ぬすむ	盗む	steal, rob
ぼんおどり	盆踊り	Bon Festival dance
ぼんち	盆地	valley, basin
ぼん	盆	Bon Festival
ぼん	盆	tray
さら	皿	plate, counter for plates or helpings
ひふ	皮膚	skin
ひにく	皮肉	cynicism, irony
かわ	皮	peel, fur
みなさま	皆様	everyone, ladies and gentlemen
みなさん	皆さん	everybody, ladies and gentlemen
みな	皆	all, everybody
ひゃっかてん	百貨店	department store
ひゃっかじてん	百科事典	encyclopedia
ひゃく	百	hundred
しらが	白髪	white hair, gray hair
はくさい	白菜	nappa cabbage
はくせん	白線	white line, warning line
はくし	白紙	blank sheet, clean slate
しろい	白い	white, blank
しろ	白	white
とうろく	登録	registration
とうこう	登校	attending school
とざん	登山	climbing, mountaineer
とうじょう	登場	appearance on stage, appearance
のぼる	登る	climb, mount, go up
はつおん	発音	pronunciation
はつでんしょ	発電所	power plant, generating station
はつでん	発電	generation of electricity
はったつ	発達	development, growth
はっしゃ	発車	start, leave
はつげん	発言	utterance, speech
はっけん	発見	discovery, revelation
はっぴょう	発表	announcement
はっこう	発行	publication, issue
はっせい	発生	occurrence, happening
はつねつ	発熱	generation of heat, get a fever
はつめい	発明	invention
はってん	発展	expansion, prosperity
はつばい	発売	sale, selling
たつ	発つ	start, leave
くせ	癖	habit, mannerism
やせる	痩せる	lose weight, become thin
いたむ	痛む	feel pain, hurt
いたみ	痛み	pain, ache
いたい	痛い	painful
しょうじょう	症状	symptom
びょういん	病院	hospital
びょうき	病気	illness
びょうし	病死	death from sickness
びょうしつ	病室	patient room, ward
びょうにん	病人	sick person, patient
ひろう	疲労	fatigue
つかれる	疲れる	get tired, become fatigued
つかれ	疲れ	fatigue, exhaustion
ぎもん	疑問	question, doubt
うたがわしい	疑わしい	doubtful, questionable
うたがう	疑う	doubt, be suspicious
うたがい	疑い	doubt, suspicion
たたむ	畳む	fold, shut
たたみ	畳	tatami, mat
いせい	異性	opposite sex
いじょう	異常	extraordinary, exceptional
ことなる	異なる	differ
ばんぐみ	番組	program
ばんち	番地	lot number, address
ばんごう	番号	number, serial number
ばん	番	one's turn, watch
りゃくす	略す	abbreviate, omit
りゃく	略	abbreviation
るすばん	留守番	caretaking, caretaker
るす	留守	not at home
りゅうがくせい	留学生	student studying abroad
りゅうがく	留学	studying abroad
はたけ	畑	field, vegetable garden
がめん	画面	screen
がか	画家	artist, painter
まちかど	町角	street corner
まちはずれ	町外れ	outskirts of a town
まちなか	町中	the downtown area, the central area of a town
まち	町	town, machi, city quarter
だんせいてき	男性的	masculine, manly
だんせい	男性	male, man
だんし	男子	boy, young man
だんじょ	男女	men and women, both sexes
おとこらしい	男らしい	manly, masculine
おとこのこ	男の子	boy, baby boy
おとこ	男	man, male
しんせい	申請	application, petition
もうす	申す	speak humbly, state humbly
もうしこむ	申し込む	apply, make a proposal
もうしこみ	申し込み	application, proposal
もうしわけない	申し訳ない	sorry, inexcusable
もうしわけ	申し訳	excuse, apology
もうしでる	申し出る	offer, propose
もうしあげる	申し上げる	speak humbly, do
いなか	田舎	country, countryside
たはた	田畑	fields and rice paddies
たうえ	田植え	rice planting
たんぼ	田んぼ	rice field
た	田	rice field, rice paddy
ようと	用途	use, service
ようし	用紙	blank form, stationery
ようい	用意	prepare, ready oneself
ようじん	用心	care, caution
ようれい	用例	example, illustration
ようけん	用件	matter, things to be done
ようじ	用事	things to do, errand, business
もちいる	用いる	use, make use of
よう	用	things to do
おい	甥	nephew
さんぎょう	産業	industry
さんふじんか	産婦人科	obstetrics and gynecology
さんち	産地	production center
なまぐさい	生臭い	smelling of fish
せいさん	生産	production
せいり	生理	period, menstruation
せいぶつ	生物	living creature, lifeform
しょうがい	生涯	for life, lifetime
せいかつ	生活	life, living
せいし	生死	life and death
なまいき	生意気	cheeky, conceited
せいと	生徒	pupil, student
せいねんがっぴ	生年月日	date of birth
せいぞん	生存	existence, survival
せいめい	生命	life
はやす	生やす	grow, cultivate
うむ	生む	have children
うみだす	生み出す	generate, produce
うまれる	生まれる	be born, come into existence
うまれつき	生まれつき	born, by nature
うまれ	生まれ	birth, origin
しょうずる	生ずる	arise, occur
しょうじる	生じる	happen, cause
いけばな	生け花	flower arrangement
いきいきと	生き生きと	lively, vividly
いきもの	生き物	living creature
いきかた	生き方	way of life, lifestyle
いきる	生きる	live (one's life)
いかす	生かす	take advantage of, make use of
はえる	生える	grow, spring up
せい	生	life
なま	生	raw, fresh
あまやかす	甘やかす	be indulgent to, spoil
あまえる	甘える	depend on, take advantage of
あまい	甘い	sweet
びん	瓶	bottle, flask
かんきょう	環境	environment, surroundings
りろん	理論	theory
りかい	理解	understanding, comprehension
りけい	理系	science
りか	理科	science
りゆう	理由	reason, cause
りそう	理想	ideal
りせい	理性	reason, reasoning power
りくつ	理屈	reason, logic
きゅう	球	globe, ball
げんきん	現金	cash
げんしょう	現象	phenomenon
げんじょう	現状	present condition
げんじつ	現実	actuality, reality
げんば	現場	actual spot, job site
げんち	現地	actual site, in the field
げんざい	現在	the present, present time
げんぞう	現像	developing a film
げんじゅうしょ	現住所	present address
げんだい	現代	present age, modern times
あらわれる	現れる	appear, emerge
あらわれ	現れ	embodiment, manifestation
あらわす	現す	show, reveal
はん	班	squad, group
めずらしい	珍しい	rare, precious
おうさま	王様	king
おう	王	king
たまねぎ	玉ねぎ	onion
たま	玉	bead, ball
そっちょく	率直	frank, openhearted
りつ	率	ratio, proportion
げんかん	玄関	entrance, door
かくとく	獲得	acquisition
けもの	獣	beast, brute
さる	猿	monkey, ape
ねこ	猫	cat, feline
せばめる	狭める	narrow, contract
せばまる	狭まる	become narrow, contract
せまい	狭い	narrow, restricted
どくしん	独身	single life, celibacy
どくりつ	独立	independence, self-reliance
どくとく	独特	peculiarity, uniqueness
どくせん	独占	exclusive possession, monopoly
ひとりごと	独り言	soliloquy, monologue
ねらう	狙う	aim, be after
くるう	狂う	become insane, get out of order
じょうきょう	状況	state of affairs, conditions
じょうたい	状態	state, appearance
はんざい	犯罪	offense, crime
はんにん	犯人	criminal, offender
おかす	犯す	offend against, rape
いぬ	犬	dog
ぎせい	犠牲	sacrifice
とくしょく	特色	characteristic
とくしゅ	特殊	special, unique
とくゆう	特有	characteristic, special
とっきゅう	特急	super-express
とくちょう	特徴	distinctive feature, characteristic
とくてい	特定	specific, particular
とくべつ	特別	special, extraordinary
とくに	特に	specially, particularly
ものおと	物音	noise, sound
ものかげ	物陰	place behind something
ぶっしつ	物質	matter, substance
ぶっし	物資	commodities, goods
ものおぼえ	物覚え	memory
ものしり	物知り	knowledgeable person, know-it-all
ぶつり	物理	physics, natural law
ものさし	物差し	ruler
ものすごい	物凄い	tremendous
ぶっか	物価	prices
ぶったい	物体	object, physical body
ものごと	物事	things, everything
もの	物	thing, object
ぼくじょう	牧場	stock farm, pasture
ぎゅうにく	牛肉	beef
ぎゅうにゅう	牛乳	milk
うし	牛	cattle, cow
かたみち	片道	one way
かたほう	片方	one side
かたて	片手	one hand
かたがわ	片側	one side
かたかな	片仮名	katakana
かたづける	片付ける	put in order, dispose of, do away with
かたづく	片付く	be put in order, be settled
さわやか	爽やか	refreshing, clear
ちちおや	父親	father
ふぼ	父母	father and mother, parents
ふけい	父兄	parents, legal guardians
ちち	父	(speaker's)father
つめきり	爪切り	nail clipper
つめ	爪	nail, claw
ばくはつ	爆発	explosion, eruption
ばくだん	爆弾	bomb
ねんりょう	燃料	fuel
もやす	燃やす	burn
もえる	燃える	burn, undergo combustion
ねっしん	熱心	enthusiasm, zeal
ねったい	熱帯	tropics
ねっする	熱する	heat, become hot
あつい	熱い	hot (things, touch)
ねつ	熱	heat, fever
にる	煮る	boil, cook
にえる	煮える	boil, be boiled
しょうめい	照明	illumination, lighting
てる	照る	shine, be fine
てらす	照らす	illuminate, shine on
えんとつ	煙突	chimney, smokestack
けむり	煙	smoke, fumes
やける	焼ける	burn, be scorched, be baked
やく	焼く	burn, bake, be envious
やきとり	焼き鳥	yakitori, grilled chicken
やきにく	焼き肉	grilled meat, barbequed meat
やきそば	焼きそば	pan-fried noodles
しょうてん	焦点	focus, focal point
あせる	焦る	feel pressured, feel hurried
こげる	焦げる	scorch, burn
むだづかい	無駄遣い	wasting money
むだ	無駄	no good, pointless
むげん	無限	infinite, endless
むかんしん	無関心	apathy, indifference
むかんけい	無関係	irrelevant, unrelated
むじゃき	無邪気	innocence, simplicity
むせきにん	無責任	irresponsibility
むろん	無論	of course, no doubt
むごん	無言	silence, muteness
むし	無視	ignoring, disregarding
むちゃ	無茶	reckless, excessive
むしょく	無色	colorless, neutral
むのう	無能	inefficiency, incompetence
むせん	無線	radio, wireless
むち	無知	ignorance
むよう	無用	useless, unnecessary
むせいぶつ	無生物	inanimate object
むりやり	無理やり	by force, against one's will
むり	無理	unreasonable, impossible, forced
むり	無理	impossibility
むりょう	無料	no charge, free
むすう	無数	countless, innumerable
むいしき	無意識	unconsciously, without thinking
むいみ	無意味	meaningless, absurd
むがい	無害	harmless
むくち	無口	not speaking much, reticence
むこう	無効	invalidity, ineffectiveness
むせいげん	無制限	unlimited, free
ぶじ	無事	safely, peacefully
なくなる	無くなる	disappear, run short, get lost
なくす	無くす	lose, get rid of
ない	無い	to not be
たく	焚く	start a fire
てんすう	点数	points, score
てん	点	point, issue
いためる	炒める	stir-fry
ほのお	炎	flame, blaze
すいじ	炊事	cooking
たく	炊く	cook, boil
さいなん	災難	calamity, misfortune
さいがい	災害	calamity, disaster
はいいろ	灰色	ash color, gray
はいざら	灰皿	ashtray
はい	灰	ashes
とうゆ	灯油	kerosene, lamp oil
かさい	火災	fire, conflagration
かようび	火曜日	Tuesday
かざん	火山	volcano
かりょく	火力	heating power, heat
かじ	火事	fire
ひ	火	fire
ぬれる	濡れる	get wet
ぬらす	濡らす	wet, moisten
こい	濃い	thick, concentrated, dark-colored
にごる	濁る	get cloudy
はげしい	激しい	violent, intense
すむ	澄む	clear, become clear
つぶれる	潰れる	crush
つぶす	潰す	crush, smash
もぐる	潜る	dive into
つけもの	漬け物	pickle, pickled vegetable
つける	漬ける	pickle, marinade
まんが	漫画	manga, comics
かんご	漢語	Chinese-character compounds
かんじ	漢字	character, kanji
かんわ	漢和	Chinese and Japanese
こぐ	漕ぐ	row
えんぜつ	演説	speech, address
えんそう	演奏	musical performance
えんげき	演劇	drama, play
えんじる	演じる	perform, play
もれる	漏れる	leak, be disclosed
もる	漏る	leak, be leaky
もらす	漏らす	give away, let leak
ぎょぎょう	漁業	fishing industry
たいざい	滞在	stay
すべる	滑る	slide, slip, flunk an examination
なめらか	滑らか	smooth, glassy
ほろびる	滅びる	go to ruin, fall
おぼれる	溺れる	drown, be drowned
とける	溶ける	be dissolved, be melted
とかす	溶かす	dissolve, melt
みぞ	溝	ditch, groove
ためいき	溜め息	sigh
ためる	溜める	store, collect
たまる	溜まる	accumulate, store up
じゅんきゅう	準急	local express
じゅんび	準備	provide for, prepare for
まんぞく	満足	satisfaction, contentment
まんてん	満点	full marks, perfect score
まんげつ	満月	full moon
まんいん	満員	full to capacity
みちる	満ちる	be filled, expire
みたす	満たす	fill, satisfy
しっけ	湿気	moisture, dampness
しつど	湿度	humidity
しめる	湿る	get damp, get wet
しめっぽい	湿っぽい	damp, gloomy
わん	湾	bay, gulf
ゆのみ	湯飲み	teacup
ゆげ	湯気	steam, vapor
ゆ	湯	hot water, hot bath, bathhouse
みずうみ	湖	lake
みなと	港	port, harbor
そくてい	測定	measure, gauge
はかる	測る	measure, gauge
おんせん	温泉	hot spring
おんだん	温暖	warm, mild
おんど	温度	temperature
おんたい	温帯	temperate zone
わたる	渡る	cross, ford, go across
わたす	渡す	carry across, hand over
げんしょう	減少	decrease, reduction
へる	減る	decrease, diminish
へらす	減らす	decrease, reduce
じゅうたい	渋滞	delay, traffic jam
しぶい	渋い	bitter, astringent
すむ	済む	be settled, complete
すませる	済ませる	finish off, get done with
すます	済ます	settle, complete
かわく	渇く	be thirsty
せいけつ	清潔	cleanliness, neatness
せいしょ	清書	clean copy
そえる	添える	add to, attach to
そう	添う	accompany, go along with
こんざつ	混雑	confusion, disorder
こんらん	混乱	disorder, confusion
こむ・こむ	混む・込む	be crowded, be congested
まぜる	混ぜる	blend, mix by stirring
まじる	混じる	be blended, get mixed
まざる	混ざる	be mixed, be stirred
しんこく	深刻	serious, grave
ふかめる	深める	deepen, intensify
ふかまる	深まる	deepen, become deeper
ふかさ	深さ	depth, profundity
ふかい	深い	deep, profound, intimate
すずしい	涼しい	cool, refreshing
えきたい	液体	liquid, fluid
えき	液	liquid, fluid
なみだ	涙	tear
しょうぼうしゃ	消防車	fire engine
しょうぼうしょ	消防署	fire station
しょうぼう	消防	fire fighting, fire prevention
しょうひしゃ	消費者	consumer
しょうひ	消費	consumption, spending
しょうかき	消火器	fire extinguisher
しょうか	消火	fire fighting
しょうどく	消毒	disinfection, sterilization
しょうきょくてき	消極的	negative, passive
しょうか	消化	digestion, consumption
けす	消す	switch off, turn off
けしごむ	消しゴム	eraser
きえる	消える	be extinguished, disappear
のり	海苔	laver
かいりゅう	海流	ocean current
かいよう	海洋	ocean, sea
かいすいよく	海水浴	sea bathing
かいすい	海水	seawater
かいきょう	海峡	straits, channel
かいがん	海岸	seashore, coast
かいがい	海外	overseas, abroad
かいじょう	海上	maritime
うみ	海	sea, ocean
あびる	浴びる	take (a shower)
うく	浮く	float
うかべる	浮かべる	set afloat
うかぶ	浮かぶ	float
はまべ	浜辺	beach, seashore
はま	浜	beach, seashore
あさい	浅い	shallow, superficial
りゅうつう	流通	circulation, distribution
はやる	流行る	be in fashion, be popular
りゅうこう	流行	fashion, trend
はやり	流行	fashion, trend
ながれる	流れる	flow, pass, drift away
ながれ	流れ	flow, stream
ながす	流す	let flow, set adrift
はばつ	派閥	clique, faction
はけん	派遣	dispatch, sending
はで	派手	showy, flashy
はしゅつじょ	派出所	branch office, police box
かつやく	活躍	activity, action
かっぱつ	活発	lively, active
かつよう	活用	utilization, conjugation
かつじ	活字	printed type
かつどう	活動	activity
こうずい	洪水	flood, inundation
せんめんじょ	洗面所	washroom, bathroom
せんめんき	洗面器	washbowl, sink
せんめん	洗面	washing one's face
せんたくき	洗濯機	washing machine
せんたく	洗濯	laundering, washing
せんざい	洗剤	detergent, cleanser
あらう	洗う	wash
あらいもの	洗い物	dishes to be washed
ようしょく	洋食	Western cooking, European dish
ようふう	洋風	Western style
ようま	洋間	Western-style room
ようが	洋画	foreign film
ようふく	洋服	clothes
ようしき	洋式	Western style
ようしつ	洋室	Western-style room
およぐ	泳ぐ	swim
ちゅうもく	注目	attention, notice
ちゅうもん	注文	order, request
ちゅういぶかい	注意深い	careful, discreet
ちゅうい	注意	attention, care, watch out
ちゅうしゃ	注射	injection, shot
そそぐ	注ぐ	pour into, concentrate
ちゅう	注	annotation, explanatory note
どろぼう	泥棒	thief, crook
どろ	泥	mud, dirt
なく	泣く	cry, weep
なきがお	泣き顔	tear-stained face
なきごえ	泣き声	tearful voice, crying
なみ	波	wave, fluctuations
ほうりつ	法律	law
ほうがくぶ	法学部	law department
ほうそく	法則	law, rule
ほう	法	law, rule
とめる	泊める	lodge, give shelter
とまる	泊まる	stay overnight
いずみ	泉	spring, fountain
えんがん	沿岸	coast, shore
そう	沿う	lie along, follow along
ちりょう	治療	medical treatment
なおる	治る	be cured, get well
おさまる	治まる	settle down, be cured
なおす	治す	cure, heal
あぶらえ	油絵	oil painting
ゆだん	油断	inattention, carelessness
あぶら	油	oil, animal oil
ふっとう	沸騰	boiling
わく	沸く	boil, be excited
わかす	沸かす	boil, excite
かこう	河口	river mouth, estuary
おき	沖	offshore
ちんぼつ	沈没	sinking
しずめる	沈める	sink, submerge
しずむ	沈む	sink, set
きしゃ	汽車	train
けつい	決意	resolution, determination
けっしん	決心	determination, resolve
けってい	決定	decision, settlement
けっしょう	決勝	final, final game
きめる	決める	decide, agree upon
きまる	決まる	be decided
きまり	決まり	settlement, rule
けっして	決して	never, by no means
くむ	汲む	collect, scoop up
いけ	池	pond
おせん	汚染	pollution, contamination
よごれる	汚れる	become dirty, become defiled
よごれ	汚れ	dirt, filth
よごす	汚す	make dirty, soil
きたない	汚い	dirty
あせ	汗	sweat
きゅうじん	求人	recruiting
もとめる	求める	seek, wish for
えいえん	永遠	eternity
えいきゅう	永久	permanence, eternity
こおり	氷	ice
すいめん	水面	surface of the water
すいどう	水道	water service, channel
みずいろ	水色	sky blue, turquoise
すいそ	水素	hydrogen
みずぎ	水着	bathing suit
すいでん	水田	paddy field, rice field
すいじゅん	水準	level, standard
すいせん	水洗	flushing, washing
すいえい	水泳	swimming
すいようび	水曜日	Wednesday
すいぞくかん	水族館	aquarium
すいへいせん	水平線	horizon
すいへい	水平	horizontal, level
すいがい	水害	flood damage
すいりょく	水力	waterpower, hydraulic power
すいちゅう	水中	in the water, underwater
みず	水	water
きがる	気軽	lighthearted, easy
きしょう	気象	weather condition
きぜつ	気絶	fainting
きおん	気温	temperature
きらく	気楽	easygoing, comfortable
きもち	気持ち	feeling, sensation
きあつ	気圧	atmospheric pressure
きりょく	気力	energy, vitality
きぶん	気分	feeling, mood
きこう	気候	climate
きたい	気体	gas, vapor
きづく	気付く	notice, become aware of
きをつける	気を付ける	take care of, pay attention to
きのどく	気の毒	pitiable, regrettable
きにいる	気に入る	like, be pleased with
き	気	spirit, temperament
みんかん	民間	citizens, civilians
みんぞく	民族	race, people
みんしゅ	民主	democracy
しめい	氏名	name
し	氏	Mr.
けいと	毛糸	woolen yarn, wool
けがわ	毛皮	fur
もうふ	毛布	blanket
け	毛	hair, wool
ひかくてき	比較的	comparatively, relatively
ひかく	比較	comparison
ひりつ	比率	ratio, percentage
ひれい	比例	proportion, ratio
くらべる	比べる	compare, contrast
どく	毒	poison, harm
まいしゅう	毎週	every week
まいあさ	毎朝	every morning
まいつき	毎月	every month
まいばん	毎晩	every evening
まいにち	毎日	every day
まいど	毎度	every time, always
まいとし	毎年	every year
まいねん	毎年	every year
ははおや	母親	mother
はは	母	(speaker's)mother
さつじん	殺人	murder, homicide
ころす	殺す	kill, smother
だんかい	段階	stage
だんらく	段落	end of paragraph
だんだん	段々	gradually, one after another
だん	段	step, grade
なぐる	殴る	hit, strike
ざんぎょう	残業	overtime
ざんしょ	残暑	lingering summer heat
ざんねん	残念	regretful, disappointing
のこる	残る	remain, be left over
のこり	残り	remainder, leftover
のこらず	残らず	entirely, without exception
のこす	残す	leave, reserve, leave undone
ことに	殊に	especially, exceptionally
ししゃ	死者	dead person, the deceased
したい	死体	corpse, body
しぼう	死亡	death
しぬ	死ぬ	die
し	死	death
れきしてき	歴史的	historical
れきし	歴史	history
さいまつ	歳末	year end
しか	歯科	dentistry
はみがき	歯磨き	toothpaste, brushing one's teeth
はいしゃ	歯医者	dentist
はぶらし	歯ブラシ	toothbrush
は	歯	tooth, cog
ほどう	歩道	sidewalk, footpath
ほこうしゃてんごく	歩行者天国	vehicle-free promenade
ほこうしゃ	歩行者	pedestrian
あるく	歩く	walk, go on foot
ぶし	武士	samurai, warrior
ぶき	武器	weapon, arms
しょうめん	正面	front, face
せいもん	正門	main gate, main entrance
せいかい	正解	right answer, correct solution
せいぎ	正義	justice, righteousness
せいかく	正確	accurate, precise
しょうじき	正直	honest, upright
しょうがつ	正月	New Year
せいほうけい	正方形	square
せいとう	正当	just, legal
せいしき	正式	formal, regular
せいざ	正座	sitting upright with legs folded under one
せいじょう	正常	normality, normalcy
しょうご	正午	noon, noontime
まさに	正に	just, surely
ただしい	正しい	correct, righteous, lawful
せい	正	right, positiveness
とめる	止める	stop, turn off
やめる	止める	stop, give up, abolish
やむ	止む	stop, abate
とまる	止まる	come to a stop, cease
かんげい	歓迎	welcome
かぶき	歌舞伎	kabuki
かしゅ	歌手	singer
うたごえ	歌声	singing voice
うたう	歌う	sing
うた	歌	song
よっきゅう	欲求	want, desire
よくぼう	欲望	desire, craving
よくばり	欲張り	greed, greedy
ほしがる	欲しがる	desire, wish for, covet
ほしい	欲しい	want, desire
よく	欲	desire, greed
おうべい	欧米	Europe and America
しだいに	次第に	gradually, by degrees
しだい	次第	as soon as
じなん	次男	second son
じじょ	次女	second daughter
じかい	次回	next time
つぐ	次ぐ	rank next to, come next
つぎつぎに	次々に	one after another, in succession
つぎ	次	next
けってん	欠点	weak point, defect
けっせき	欠席	absence, nonattendance
かける	欠ける	be chipped, be missing
かく	欠く	lack
らん	欄	column, field
きかん	機関	engine, agency
きちょう	機長	airplane captain
きのう	機能	function, feature
きかい	機械	machine
きげん	機嫌	mood, health
きかい	機会	opportunity, occasion
はし	橋	bridge
よこがお	横顔	profile, face seen from side
よこがき	横書き	horizontal writing
おうだんほどう	横断歩道	pedestrian crossing, crosswalk
おうだん	横断	crossing, traversing
よこぎる	横切る	cross, go across
よこ	横	side, width across
けんい	権威	authority, power
けんりょく	権力	power, authority
けんり	権利	right, privilege
もはん	模範	model, role model
もよう	模様	pattern, design
ひょうじゅん	標準	standard, norm
ようす	様子	appearance, aspect
さまざま	様々	various, diverse
こうぞう	構造	construction, structure
こうせい	構成	organization
こうそう	構想	conception, design
かまえる	構える	set up (shop)
かまう	構う	mind, care for
がいねん	概念	general idea, concept
がっき	楽器	musical instrument
たのしむ	楽しむ	enjoy
たのしみ	楽しみ	pleasure, something looked forward to
たのしい	楽しい	fun, enjoyable
らく	楽	comfort, relief
きょくたん	極端	extreme
きわめて	極めて	extremely, very
ぎょうしゃ	業者	businessman
ぎょうせき	業績	achievement, performance
ぎょうかい	業界	industry, business world
けんとう	検討	consideration, inspection
けんさ	検査	inspection, examination
しょくぶつえん	植物園	botanical garden
しょくぶつ	植物	plant, vegetation
しょくみんち	植民地	colony, settlement
うえき	植木	garden plant, shrub
うえる	植える	plant, raise
いす	椅子	chair
しんりん	森林	forest, woodland
もり	森	thick woods, forest
たな	棚	cupboard, shelf, rack
ぼう	棒	rod, stick
きけん	棄権	dropping out, renouncing rights
つゆあけ	梅雨明け	end of the rainy season
つゆいり	梅雨入り	start of the rainy season
つゆ	梅雨	rainy season
うめぼし	梅干	pickled plum
うめ	梅	plum blossom
さくら	桜	cherry tree, cherry blossom
あんがい	案外	unexpectedly
あんない	案内	guide, inform
あんのじょう	案の定	as feared, sure enough
あん	案	plan, proposal
もも	桃	peach, peach tree
さいばい	栽培	cultivation, raising
かくさ	格差	gap, disparity
かっこう	格好	shape, appearance
こんぽん	根本	basis, root
こんきょ	根拠	grounds, basis
ね	根	root, source
かく	核	core, atomic nucleus
かぶしき	株式	stock
かぶ	株	stocks, shares
こうちょう	校長	principal, schoolmaster
こうしゃ	校舎	school building
こうてい	校庭	schoolyard, campus
せんぬき	栓抜き	bottle opener, corkscrew
えいよう	栄養	nutrition, nourishment
さかえる	栄える	flourish, thrive
かき	柿	persimmon, persimmon tree
はしら	柱	pillar, prop
じゅうどう	柔道	judo
じゅうなん	柔軟	pliable, flexible
やわらかい	柔らかい	soft
やわらかい	柔らかい	soft, gentle
やわらか	柔らか	soft, tender, gentle
そめる	染める	dye, color
がら	柄	pattern, design
え	柄	handle, grip
かれる	枯れる	wither, die
わく	枠	frame, limits
えだ	枝	branch, twig
くだもの	果物	fruit
はたす	果たす	accomplish, realize
はたして	果たして	as was expected, really
まいすう	枚数	number of flat things
はやし	林	woods, grove
まくら	枕	pillow
いた	板	board, plank
とうざい	東西	east and west
とうよう	東洋	Orient
ひがし	東	east, eastern
らいしゅう	来週	next week
らいげつ	来月	next month
らいにち	来日	coming to Japan
らいねん	来年	next year
くる	来る	come
じょうやく	条約	treaty
じょうけん	条件	condition, item
たば	束	bundle, counter for bundles
むら	村	village, hamlet
ざいもく	材木	timber, wood
ざいりょう	材料	material, factor
つくえ	机	desk, table
さつ	札	bill, paper money
ふだ	札	sign, billboard
ほんぶ	本部	head office, headquarters
ほんしつ	本質	essence, reality
ほんのう	本能	instinct
ほんばこ	本箱	bookcase
ほんしゃ	本社	head office
ほんもの	本物	real thing, genuine article
ほんき	本気	seriousness, earnestness
ほんだな	本棚	bookshelf
ほんかくてき	本格的	full-scale, authentic
ほんらい	本来	originally, essentially
ほんじつ	本日	today
ほんぶん	本文	text, this text
ほんとうに	本当に	really, truly
ほんとう	本当	truth, reality
ほんてん	本店	head office
ほんねん	本年	this year
ほんや	本屋	bookstore, bookseller
ほんごく	本国	one's native country
ほんにん	本人	the person himself, the said person
ほん	本	book, volume
すえっこ	末っ子	youngest child
すえ	末	(after) the end
まつ	末	last part, end
みち	未知	unknown
みらい	未来	future
みせいねん	未成年	minor, underage
みてい	未定	undecided, pending
みこん	未婚	unmarried
まだ	未だ	yet, more
もくぞう	木造	wooden
もめん	木綿	cotton
こがらし	木枯らし	cold wintry wind
もくようび	木曜日	Thursday
このは	木の葉	tree leaves
き	木	tree, wood
きげん	期限	time limit, term
きかん	期間	term, period
きじつ	期日	date, due date
きたい	期待	expectation, anticipation
ちょうしょく	朝食	breakfast
あさがお	朝顔	morning glory
あさひ	朝日	morning sun
あさごはん	朝御飯	breakfast
ちょうかん	朝刊	morning edition
あさ	朝	morning
のぞむ	望む	desire, hope
のぞみ	望み	desire, hope
のぞましい	望ましい	desirable, welcome
ほがらか	朗らか	cheerful, bright
ふくそう	服装	clothes, garments
ふく	服	clothes
ゆうげん	有限	limited, finite
ゆうのう	有能	able, competent
ゆうえき	有益	beneficial, profitable
ゆうどく	有毒	poisonous, noxious
ゆうぼう	有望	promising, hopeful
ゆうりょう	有料	fee-charging, pay
ゆうがい	有害	harmful, hazardous
ゆうめい	有名	famous
ゆうこう	有効	effective, valid
ゆうりょく	有力	powerful, influential
ゆうり	有利	advantageous, profitable
ある	有る	exist, possess
ありがたい	有り難い	welcome, grateful
ありのまま	有りのまま	as it is, unchanged
ゆうする	有する	have, possess
げっしゃ	月謝	monthly fee
つきみ	月見	moon viewing
げっきゅう	月給	monthly salary
げつまつ	月末	end of the month
げつようび	月曜日	Monday
つきひ	月日	time, days
がっぴ	月日	date
つきよ	月夜	moonlit night
つきはじめ	月初め	at the beginning of the month
げっかん	月刊	published monthly
つき	月	moon
さいこう	最高	maximum, supreme
さいてき	最適	optimum
さいきん	最近	late, recent
さいしゅう	最終	last, final
さいあく	最悪	the worst
さいご	最後	last, final
さいきょう	最強	strongest
さいしょう	最小	the smallest, minimum
さいだい	最大	biggest, largest
さいしょ	最初	first, outset
さいせんたん	最先端	cutting edge, forefront
さいてい	最低	lowest
さいちゅう	最中	in the middle of, during
さいじょう	最上	best, highest
もっとも	最も	the most
しょるい	書類	documents, papers
しょどう	書道	Japanese calligraphy
かきとめ	書留	registered mail
しょもつ	書物	book, volume
しょてん	書店	bookstore
かく	書く	write
かきことば	書き言葉	written language
かきなおす	書き直す	rewrite
かきかた	書き方	how to write, way of writing
かきとる	書き取る	write down, note down
かきとり	書き取り	dictation
さらに	更に	furthermore, still more
きょくせん	曲線	curve, curved line
まげる	曲げる	bend, curve
まがる	曲がる	turn
まがりかど	曲がり角	corner
きょく	曲	song, melody, tune
ようび	曜日	day of the week
あいまい	曖昧	ambiguous, vague
くもる	曇る	become cloudy
くもり	曇り	cloudiness, cloudy weather
ぼうらく	暴落	slump, crash
ぼうりょく	暴力	violence, force
あばれる	暴れる	act violently, rage about
くれる	暮れる	grow dark
くれ	暮れ	dusk, the end (of a season or a year)
くらす	暮らす	live, earn one's livelihood
くらし	暮らし	living, livelihood
こよみ	暦	calendar, almanac
あんき	暗記	memorization
くらい	暗い	dark, dreary, shadowy
だんぼう	暖房	heating
あたためる	暖める	warm, warm up, heat up
あたたまる	暖まる	get warm
あたたかい	暖かい	warm
あたたか	暖か	warm, warmhearted
しょちゅうみまい	暑中見舞い	summer greeting
あつさ	暑さ	heat, summer heat
あつい	暑い	hot, warm (temperature of the air)
ひま	暇	free time, spare time
はれる	晴れる	be sunny, clear up
はれ	晴れ	fine weather, clear sky
けしき	景色	scenery, landscape
けいき	景気	economic climate
ふつう	普通	normal, regular
ふだん	普段	usual, ordinary
ふきゅう	普及	diffusion, spread
ばんねん	晩年	late in life
ばん	晩	evening (usually from sunset to bedtime)
じかんわり	時間割り	time table
じかん	時間	time, hour
じそく	時速	speed per hour
とけい	時計	clock, watch
じきゅう	時給	hourly wage
じき	時機	opportunity, chance
じき	時期	time, season
じさ	時差	time difference
じこく	時刻	time, hour
じだい	時代	age, antiquity
ときどき	時々	sometimes
とき	時	time
ちゅうしょく	昼食	lunch
ひるま	昼間	daytime, day
ひるすぎ	昼過ぎ	early afternoon
ひるね	昼寝	siesta, nap
ひるまえ	昼前	in the morning, before noon
ひるやすみ	昼休み	noon recess, lunch break
ひる	昼	daytime, midday
ぜひ	是非	by all means, at any cost
しょうわ	昭和	Showa era
さくばん	昨晩	last night, last evening
きのう	昨日	yesterday
さくじつ	昨日	yesterday
さくねん	昨年	last year
さくや	昨夜	last night
ゆうべ	昨夜	last night, last evening
しゅんかしゅうとう	春夏秋冬	four seasons, all year round
しゅんぶん	春分	vernal equinox
はる	春	spring
えいがかん	映画館	movie theater
えいが	映画	movie
うつる	映る	be reflected, appear
うつす	映す	reflect, project
ほし	星	star, planet, spot
むかし	昔	old times, the old days
やさしい	易しい	easy, simple
めいかく	明確	clear, precise
めいりょう	明瞭	clear, plain
めいはく	明白	clear, plain
めいじ	明治	Meiji era
みょうちょう	明朝	tomorrow morning
あす	明日	tomorrow
あした	明日	tomorrow
みょうにち	明日	tomorrow
あさって	明後日	day after tomorrow
あかるい	明るい	bright, cheerful
あきらか	明らか	clear, obvious
あけがた	明け方	dawn, near daybreak
あける	明ける	to dawn
あかり	明かり	light
しあさって	明々後日	three days from today
のぼる	昇る	rise,
さっそく	早速	immediately
そうたい	早退	early departure
はやおき	早起き	early rising
そうちょう	早朝	early morning
はやね	早寝	going to bed early
はやくち	早口	fast talking
はやめる	早める	move forward (in time), expedite
はやまる	早まる	make a hasty decision, jump the gun
はやく	早く	early, soon
はやい	早い	early
きゅう	旧	old, former
にっかん	日韓	Japan and Korea
ひかげ	日陰	the shade
にっか	日課	daily routine
にっき	日記	diary
にちべい	日米	Japan and U.S.
にってい	日程	program, schedule
にちようひん	日用品	groceries, daily necessities
ひやけ	日焼け	suntan
にほんしゅ	日本酒	sake, rice wine
にちようび	日曜日	Sunday
にちじ	日時	date, time
ひにち	日日	date, number of days
にっすう	日数	number of days
ひあたり	日当たり	exposure to the sun
にちじょう	日常	daily, everyday
ひがえり	日帰り	a day trip
ひざし	日差し	rays of the sun, sunlight
にっこう	日光	sunshine, sunlight
ひづけ	日付け	date
にっちゅう	日中	during the day
にっちゅう	日中	Sino-Japanese
ひので	日の出	sunrise
ひのいり	日の入り	sunset
ひのまる	日の丸	Rising Sun Flag, Japanese flag
にっそ	日ソ	Japanese-Soviet
ひごろ	日ごろ	routinely, daily
ひび	日々	daily, every day
ひ	日	sun, sunlight, day
にち	日	day
にち	日	Japan
きせい	既製	ready-made, ready-to-wear
すでに	既に	already, previously
はた	旗	flag, banner
りょかん	旅館	Japanese inn
りょひ	旅費	traveling expenses
りょこう	旅行	travel, trip
りょかくき	旅客機	passenger plane
りょかく	旅客	traveler, passenger
たび	旅	journey, travel
しせつ	施設	facilities, institution
ほうめん	方面	direction
ほうしん	方針	course, policy
ほうげん	方言	dialect
ほうがく	方角	direction
ほうほう	方法	method, procedure
ほうこう	方向	direction, course
かたがた	方々	people
ほうぼう	方々	everyone, all people
かた	方	person　（polite form)
ほう	方	direction, side
しんせん	新鮮	fresh
しんぶんしゃ	新聞社	newspaper office
しんぶん	新聞	newspaper
しんちく	新築	new building
しんかんせん	新幹線	Shinkansen, Bullet Train
しんねん	新年	New Year
しんがっき	新学期	new term, new semester
しんこん	新婚	newlywed
しんじん	新人	newcomer, freshman
あらた	新た	new, fresh
あたらしい	新しい	new
だんすい	断水	water stoppage
だんてい	断定	decision, conclusion
ことわる	断る	refuse, turn down
ななめ	斜め	diagonal, slant
りょうきん	料金	charge, fee
りょうり	料理	cooking, handling
ぶんけい	文系	liberal arts, humanities
ぶんしょう	文章	writing, prose
ぶんぽう	文法	grammar
ぶんめい	文明	civilization, culture
ぶんぼうぐ	文房具	stationery, writing materials
ぶんがくしゃ	文学者	literary person, literati
ぶんがく	文学	literature
もじ	文字	character, letter
もんく	文句	complaint
ぶんかざい	文化財	cultural assets
ぶんかてき	文化的	cultural
ぶんか	文化	culture
ぶん	文	writings, sentence
しききん	敷金	deposit, key money
しく	敷く	lay, spread
てき	敵	enemy, foe
せいり	整理	disposition, arrangement
せいれつ	整列	row, line
せいび	整備	maintenance, servicing
ととのえる	整える	arrange, adjust
ととのう	整う	be in order, be adjusted
すうがく	数学	mathematics
すうじ	数字	figure, numeral
かぞえる	数える	count, calculate
かず	数	number
けいご	敬語	honorific language, polite speech
うやまう	敬う	respect, honor
さんぽ	散歩	walk, stroll
ちる	散る	scatter, fall
ちらばる	散らばる	be scattered
ちらかる	散らかる	lie scattered about, be in disorder
ちらかす	散らかす	scatter, disarrange
きょうよう	教養	culture, education
きょういく	教育	education
きょうかしょ	教科書	textbook, schoolbook
きょうじゅ	教授	professor
きょうし	教師	teacher, instructor
きょうしつ	教室	classroom, class
きょういん	教員	teacher, teaching staff
きょうかい	教会	church
おそわる	教わる	be taught, learn
おしえる	教える	teach, tell
おしえ	教え	lesson, teachings
はいせん	敗戦	lost battle, defeat
やぶれる	敗れる	be defeated, be beaten
きゅうきゅうしゃ	救急車	ambulance
きゅうじょ	救助	rescue, relief
すくう	救う	save, relieve
すくい	救い	rescue, relief
びんかん	敏感	sensitive
こしょう	故障	malfunction, fault, breakdown
こきょう	故郷	hometown, birthplace
せいさく	政策	policy, political measures
せいじか	政治家	politician
せいじ	政治	politics
せいけん	政権	political power
せいふ	政府	government, administration
せいとう	政党	political party
ほうそう	放送	broadcasting
ほうしゃのう	放射能	radioactivity
ほうる	放る	fling, hurl
はなす	放す	release, free
こうげき	攻撃	attack, criticism
せめる	攻める	attack, take the offensive
かいかく	改革	reform
かいぞう	改造	remodeling, reorganization
かいりょう	改良	improvement, reform
かいせい	改正	revision, amendment
かいさつぐち	改札口	ticket barrier, wicket
かいさつ	改札	ticket gate
かいぜん	改善	improvement, amelioration
あらためる	改める	reform, change
あらためて	改めて	once again
あらたまる	改まる	be renewed, change
しはい	支配	control, management
ししゃ	支社	branch office
しえん	支援	support, backing
しじ	支持	support, maintenance
しはらう	支払う	pay
しはらい	支払い	payment, payout
したく	支度	arrangement, preparation
してん	支店	branch
ししゅつ	支出	expenditure, disbursement
ささえる	支える	support, maintain
こする	擦る	rub, strike
そうじゅう	操縦	steering, piloting
そうさ	操作	operation, manipulation
さつえい	撮影	photographing, shoot
とる	撮る	photograph, shoot, film
なでる	撫でる	stroke, pat
うつ	撃つ	fire, shoot
まさつ	摩擦	friction, rubbing
そんがい	損害	damage, harm
そんする	損する	lose, suffer loss
そん	損	loss, damage
ゆれる	揺れる	shake, sway, rock
えんじょ	援助	aid, assistance
あくしゅ	握手	handshake, handshaking
にぎる	握る	grasp, make hand-rolled sushi balls
にぎりしめる	握り締める	squeeze, grip
かえる	換える	exchange, convert
あげる	揚げる	deep-fry
ていあん	提案	proposition, proposal
ていしゅつ	提出	submittal
ていきょう	提供	offer, provide
えがく	描く	depict, describe
そろえる	揃える	align, make uniform
そろう	揃う	be (all) together
かく	掻く	scratch
かきまわす	掻き回す	stir up, agitate
けいじばん	掲示板	notice board, bulletin board
けいじ	掲示	notice, bulletin
そち	措置	measure, step
すいしん	推進	promotion
すいせん	推薦	recommendation, nomination
すいそく	推測	conjecture, guess
ひかえしつ	控え室	waiting room
ひかえる	控える	hold back, show moderation
せっきん	接近	approach, proximity
せつぞく	接続	connection, joining
せっする	接する	come in contact, adjoin
さがす	探す	search for, look for
さいさん	採算	profit
さいよう	採用	employment
さいてん	採点	marking, grading
とる	採る	gather, pick
かけざん	掛け算	multiplication
かける	掛ける	hang, put on
かかる	掛かる	hang, splash, require
ほる	掘る	dig, unearth
じゅぎょう	授業	class, lesson
そうじき	掃除機	vacuum cleaner
そうじ	掃除	cleaning
はく	掃く	sweep, brush
すてる	捨てる	discard, abandon
そうさ	捜査	criminal investigation, search
さがす	捜す	look for, search for
つかまる	捕まる	be caught, be arrested
つかまえる	捕まえる	arrest, capture
しんどう	振動	vibration
ふる	振る	wave, shake, brandish
ふりかえる	振り返る	turn one's head, turn round
ふりむく	振り向く	turn around, look back
ふりがな	振り仮名	reading aid in kana characters
ふり	振り	swing, shake
あいさつ	挨拶	greet, greeting
はさむ	挟む	trap
あげる	挙げる	cite, give (an example)
ちょうせん	挑戦	challenge
ゆびわ	指輪	ring
してき	指摘	identification, pointing out
しき	指揮	command, initiative
ゆびさす	指差す	point to
しどう	指導	guide, lead
してい	指定	designation, appointment
さす	指す	point to, aim at
ゆび	指	finger, toe
もっていく	持って行く	take
もってくる	持って来る	bring
もつ	持つ	have, possess
もつ	持つ	maintain, last long
もちこむ	持ち込む	bring in, carry on
もちもの	持ち物	one's property, one's baggage
もちぬし	持ち主	owner, proprietor
ひろう	拾う	pick up, find
ふく	拭く	wipe, dry
かっこ	括弧	parentheses, brackets
かくちょう	拡張	expansion, extension
かくだい	拡大	magnification, enlargement
はいけん	拝見	humbly look at or see
おがむ	拝む	bow in veneration, worship
しょうたい	招待	invitation
まねく	招く	invite, beckon, engage
きょひ	拒否	denial, rejection
はくしゅ	拍手	applause, clapping
たんとう	担当	person in charge
たんにん	担任	supervisor
かつぐ	担ぐ	shoulder, carry
ちゅうしょうてき	抽象的	abstract
おしいれ	押し入れ	closet
おさえる	押さえる	hold down
ていこう	抵抗	resistance, opposition
いだく	抱く	embrace, hug
だく	抱く	hug, embrace
かかえる	抱える	hold in one's arms
ぬける	抜ける	come out, leave
ぬく	抜く	pull out
おれる	折れる	snap, be folded, give in
おる	折る	break off, fold, bend
こうぎ	抗議	protest, remonstrance
とうし	投資	investment
とうひょう	投票	vote, ballot
とうしょ	投書	contribution, letter
なげる	投げる	throw, abandon
おさえる	抑える	suppress, bring under control
ぎじゅつ	技術	skill, technology
ぎし	技師	engineer, technician
しょうにん	承認	approval, recognition
しょうち	承知	consent, knowledge
ひひょう	批評	criticism, comment
ひはん	批判	criticism, comment
あつかう	扱う	handle, deal with
はらう	払う	pay
はらいこむ	払い込む	pay in, pay up
はらいもどす	払い戻す	pay back, reimburse
はらい	払い	payment, account
うつ	打つ	hit, strike
うちこむ	打ち込む	devote oneself
うちけし	打ち消し	negation, denial
うちあける	打ち明ける	confide in, reveal
うちあわせる	打ち合わせる	arrange, discuss
うちあわせ	打ち合わせ	meeting, arrangement
うちあげる	打ち上げる	shoot up
さいのう	才能	talent, ability
てくび	手首	wrist
てま	手間	trouble, time
てがる	手軽	easy, light
てあし	手足	hands and feet, limbs
てぶくろ	手袋	gloves
しゅじゅつ	手術	surgical operation
てつづき	手続き	procedure, formalities
てがみ	手紙	letter
てあらい	手洗い	toilet, washstand
しゅだん	手段	means, way
てほん	手本	model, example
てすう	手数	trouble, bother
てあて	手当て	allowance, medical care
てちょう	手帳	pocketbook, memo
てまえ	手前	in front
ていれ	手入れ	care, repairs
てもと	手元	at hand
てつだう	手伝う	help, assist
てつだい	手伝い	help, assistant
て	手	hand
とびら	扉	door
せんぷうき	扇風機	electric fan
しょとく	所得	income, earnings
しょぞく	所属	belonging, attachment
ところどころ	所々	here and there, at places
もどる	戻る	return, turn back
もどす	戻す	return, give back
こせき	戸籍	family register
とだな	戸棚	closet, cupboard
と	戸	door, shutter
せんし	戦死	death in war
せんご	戦後	postwar period
せんじょう	戦場	battlefield, front
せんぜん	戦前	prewar period
せんそう	戦争	war, battle
たたかう	戦う	wage war, fight
たたかい	戦い	war, match
がまん	我慢	patience, self-restraint
わがや	我が家	one's home
わがくに	我が国	our country, Japan
われわれ	我々	we
せいちょう	成長	growth
せいせき	成績	results, record
せいりつ	成立	formation
せいか	成果	result, fruit
せいねん	成年	majority, adult
せいこう	成功	success
せいじん	成人	adult, grownup
なりたつ	成り立つ	consist of, be built on
かける	懸ける	stake
なつかしい	懐かしい	longed-for, old
けんぽう	憲法	constitution, constitutional law
あこがれる	憧れる	yearn after, adore
あこがれ	憧れ	yearning, longing
にくらしい	憎らしい	hateful, horrible
にくむ	憎む	hate, detest
にくしみ	憎しみ	hatred, enmity
にくい	憎い	hateful, abominable
なぐさめる	慰める	console, comfort
かんようく	慣用句	idiom, common phrase
なれる	慣れる	grow accustomed to
なれ	慣れ	getting used to, habituation
ならす	慣らす	accustom
しんちょう	慎重	prudence, discretion
あわてる	慌てる	be flurried, hurry
あわただしい	慌ただしい	busy
たいど	態度	attitude, manner
たいせい	態勢	state, preparedness
かんしゃ	感謝	gratitude, thanks
かんかく	感覚	sense, sensation
かんげき	感激	deep emotion, moving
かんそう	感想	thought, impression
かんじょう	感情	feeling, emotion
かんしん	感心	admiration
かんどう	感動	emotion, impression
かんじる	感じる	feel, sense
かんじ	感じ	feeling, impression
あいじょう	愛情	love, affection
あいする	愛する	love, care for
あい	愛	love
いしき	意識	consciousness, awareness
いけん	意見	opinion
いぎ	意義	meaning, significance
いよく	意欲	volition, motivation
いし	意志	will, volition
いがい	意外	unexpected, unforeseen
いじわる	意地悪	nastiness, ill-natured person
いと	意図	intention, aim
いみ	意味	meaning, significance
いこう	意向	intention, inclination
ゆかい	愉快	pleasant, delightful
そうぞう	想像	imagination
みじめ	惨め	miserable, pitiable
おしむ	惜しむ	grudge, regret
おしい	惜しい	almost, close
じょうねつ	情熱	passion, enthusiasm
じょうほう	情報	information
じょうせい	情勢	state of things, situation
なさけない	情けない	pitiful, shameful
ひめい	悲鳴	shriek, scream
ひげき	悲劇	tragedy, tragic drama
かなしむ	悲しむ	feel sad, lament
かなしみ	悲しみ	grief, sadness
かなしい	悲しい	sad
あくしつ	悪質	bad, malignant
わるがしこい	悪賢い	cunning, sly
あくよう	悪用	abuse, misuse
あくじょ	悪女	wicked woman, villainess
わるくち	悪口	slander, abuse
あっか	悪化	worsening, aggravation
わるい	悪い	bad
あく	悪	evil, badness
なやむ	悩む	be troubled, suffer
なやみ	悩み	troubles, worries
かんじゃ	患者	patient
くやしい	悔しい	vexing, frustrating
めぐまれる	恵まれる	be blessed, be privileged
むすこ	息子	son
いき	息	breath
おん	恩	debt of gratitude, kindness
うらむ	恨む	hold a grudge, feel resentment
うらみ	恨み	grudge, hatred
はずかしい	恥ずかしい	shy, ashamed, disgraceful
はじ	恥	shame, disgrace
おそろしい	恐ろしい	terrible, awful
おそれる	恐れる	fear, apprehend
おそれ	恐れ	fear, risk
おそらく	恐らく	probably
れんあい	恋愛	love
こいびと	恋人	lover, sweetheart
こいする	恋する	love, fall in love with
こい	恋	love, romance
けが	怪我	injury
あやしむ	怪しむ	suspect
あやしい	怪しい	suspicious, dubious
せいしつ	性質	nature, property
せいのう	性能	performance, capacity
せいかく	性格	character, personality
せいべつ	性別	sex, gender
せい	性	sex, nature
きゅうそく	急速	rapid, swift
きゅうこう	急行	express train, going in a hurry
きゅうびょう	急病	sudden illness
きゅうよう	急用	urgent business
きゅうげき	急激	sudden, abrupt
きゅうぞう	急増	sudden increase
きゅうに	急に	suddenly, unexpectedly
いそぐ	急ぐ	hurry, hasten
きゅう	急	urgent, dire, pressing
なまける	怠ける	be lazy, neglect
しそう	思想	thought, conception
おもわず	思わず	unintentionally, unconsciously
おもう	思う	think
おもいこむ	思い込む	assume, believe
おもいきり	思い切り	to one's heart's content, with all one's might
おもいきって	思い切って	boldly, decisively
おもいだす	思い出す	recollect, recall
おもいで	思い出	recollections, memory
おもいつく	思い付く	think of, hit upon
おもいやり	思いやり	thoughtfulness, kindness
おもいがけない	思いがけない	unexpected, accidental
おもい	思い	thoughts, feelings
こわがる	怖がる	be afraid of, fear
こわい	怖い	fearful, be afraid
おこる	怒る	get angry, scold
いかり	怒り	anger, rage
かいせい	快晴	fair and clear weather
こころよい	快い	pleasant, agreeable
ちゅうじつ	忠実	faithfulness, devotion
ちゅうこく	忠告	advice, admonishment
おうよう	応用	application
おうえん	応援	support, cheering
おうぼ	応募	application
おうじる	応じる	answer, comply with
いそがしい	忙しい	busy, occupied
ぼうねんかい	忘年会	year-end party
わすれもの	忘れ物	something left behind, lost item
わすれる	忘れる	forget, leave behind
こころざす	志す	have an ambition for, aspire
ひつよう	必要	need, necessity
ひつぜん	必然	inevitable, necessary
ひっしに	必死に	desperately
ひっし	必死	desperation
かならずしも	必ずしも	not always, not necessarily
かならず	必ず	without fail, certainly
しんぱい	心配	anxiety, worry, good offices
しんしん	心身	mind and body
しんぞう	心臓	heart
こころぼそい	心細い	helpless, lonely
しんり	心理	mental state, psychology
こころがける	心掛ける	bear in mind, try
こころづよい	心強い	reassuring, heartening
こころ	心	heart, mind
てっていてき	徹底的	thorough, exhaustive
てつや	徹夜	staying up all night
びみょう	微妙	subtle, delicate
かすか	微か	faint, dim
ふくしゅう	復習	review
ふっかつ	復活	revival, rebirth
ごぶさた	御無沙汰	be out of touch
とくい	得意	one's forte, pride, customer
える	得る	obtain, gain
とくする	得する	profit, gain
とく	得	gain, advantage
じゅうぎょういん	従業員	employee, worker
じゅうらい	従来	former, old
いとこ	従兄弟	cousin
したがう	従う	follow, obey
とほ	徒歩	walking, going on foot
じょこう	徐行	slow speed
こうはい	後輩	one's junior
こうしゃ	後者	the latter
あとかたづけ	後片付け	cleaning up
こうき	後期	latter period
あとがき	後書き	postscript, afterword
こうほう	後方	back, rear
あともどり	後戻り	turning back, retreat
こうかい	後悔	regret
あとまわし	後回し	deferment, postponement
こうはん	後半	latter half, second half
うしろむき	後ろ向き	facing backward
うしろ	後ろ	back, behind
あと	後	after
のち	後	after, afterwards
たいぐう	待遇	treatment, pay
まちあいしつ	待合室	waiting room
まつ	待つ	wait, wait for
まちどおしい	待ち遠しい	just can't wait for, long for
まちのぞむ	待ち望む	expect, look forward to
まちあわせる	待ち合わせる	wait for, meet by appointment
まちあわせ	待ち合わせ	waiting, rendez-vous
おうふく	往復	going and returning, round trip
かのじょ	彼女	she, one's girlfriend
かれら	彼ら	they
かれ	彼	he, one's boyfriend
やくだつ	役立つ	be of use, serve a purpose
やくめ	役目	duty, role
やくしょ	役所	public office
やくわり	役割	role, part
やくにん	役人	government official
やくにたつ	役に立つ	be useful, be helpful
やく	役	role, part
えいきょう	影響	influence, effect
かげ	影	shadow, shade
ほる	彫る	engrave, carve
けいせい	形成	formation
けいしきてき	形式的	formal
けいしき	形式	form, model
けいようし	形容詞	adjective
かたち	形	shape, form
とうせん	当選	election to office
とうばん	当番	being on duty, person on duty
とうぜん	当然	natural, as a matter of course
とうじ	当時	at that time, at the present time
とうじつ	当日	that day
とうきょく	当局	the authorities concerned
とうしょ	当初	original, initial
とうぶん	当分	for some time, for the present
とうにん	当人	the person in question
あてる	当てる	guess, hit the jackpot
あたる	当たる	hit, strike
あたりまえ	当たり前	of course, obvious
あたり	当たり	hit, success
はずむ	弾む	spring back, bounce
ひく	弾く	play on
たま	弾	bullet, shot
きょうちょう	強調	emphasis, stress
ごうとう	強盗	robbery
きょうれつ	強烈	intense, severe
つよき	強気	tough, bullish
ごういん	強引	overbearing, coercive
きょうか	強化	strengthening
きょうりょく	強力	powerful
きょうせい	強制	compulsion, force
つよめる	強める	strengthen, emphasize
つよまる	強まる	become strong, gain strength
つよさ	強さ	strength, power
つよい	強い	strong
はる	張る	strain, be stretched
はりきる	張り切る	go all out, make efforts
じゃくてん	弱点	weak point
よわき	弱気	timid, weak-spirited
よわる	弱る	weaken, be debilitated
よわめる	弱める	weaken, lower
よわみ	弱み	weakness, shortcoming
よわまる	弱まる	weaken, abate
よわい	弱い	weak
おとうと	弟	younger brother
いんよう	引用	quotation, citation
ひっこむ	引っ込む	draw back, pull in
ひっこす	引っ越す	move, change quarters
ひっこし	引っ越し	moving
ひっかける	引っ掛ける	hook on
ひっかかる	引っ掛かる	be caught, be trapped
ひっぱる	引っ張る	pull, drag
ひく	引く	draw, pull
ひきかえす	引き返す	turn back, retrace one's steps
ひきざん	引き算	subtraction
ひきとめる	引き止める	detain, keep
ひきのばす	引き延ばす	extend, prolong
ひきうける	引き受ける	undertake
ひきとる	引き取る	take over, take custody
ひきわけ	引き分け	draw, drawn game
ひきだす	引き出す	draw out, lure out
ひきだし	引き出し	drawer, withdrawal
ひきのばす	引き伸ばす	stretch out, enlarge
ひきあげる	引き上げる	pull up, salvage
ひきずる	引きずる	drag along, trail
しき	式	ceremony
べんごし	弁護士	lawyer, attorney
べんご	弁護	defense
べんろん	弁論	discussion, oral proceedings
べんとう	弁当	box lunch, picnic lunch
けんせつ	建設	construction, building
けんちく	建築	construction, architecture
たてもの	建物	building, structure
たてまえ	建て前	a front, polite face
たてる	建てる	build, erect
たつ	建つ	be built, be erected
えんちょう	延長	extension, prolongation
えんき	延期	postponement, deferment
のびる	延びる	extend, be postponed
のばす	延ばす	extend, postpone
ろうか	廊下	hallway, corridor
はいし	廃止	abolishment, abandonment
にわ	庭	garden, court
ざしき	座敷	drawing room, Japanese-style room
ざせき	座席	seat
ざぶとん	座布団	cushion
すわる	座る	sit, sit down
どわすれ	度忘れ	memory lapse, mental block
たびたび	度々	often
ふりつ	府立	prefectural
ふちょう	府庁	urban prefectural office
ふ	府	urban prefecture
てんいん	店員	clerk, salesperson
みせ	店	shop, store
そこ	底	bottom, depths
とこや	床屋	barber, barbershop
ゆか	床	floor
ひろば	広場	square, open space
こうこく	広告	public notice, advertisement
ひろめる	広める	spread, extend
ひろまる	広まる	spread, be in general circulation
ひろさ	広さ	area, extent
ひろげる	広げる	spread, unfold
ひろがる	広がる	spread out, reach
ひろい	広い	wide, big
ちょう	庁	public office, agency
いくら	幾ら	how much
いくら	幾ら	no matter how much
いくつ	幾つ	how many, how old
ようちえん	幼稚園	kindergarten
ようち	幼稚	childish, infantile
ようじ	幼児	young child, infant
おさない	幼い	young, childish
かんぶ	幹部	executive
みき	幹	tree trunk
こううん	幸運	good fortune, good luck
こうふく	幸福	happiness, good fortune
しあわせ	幸せ	happiness, good fortune
さいわい	幸い	happiness, good fortune
ねんれい	年齢	age, years
ねんかん	年間	period of one year
ねんちょう	年長	seniority
ねんぱい	年配	age, elderly age
ねんがじょう	年賀状	New Year's card
ねんが	年賀	New Year's card
ねんまつ	年末	end of year
ねんがっぴ	年月日	date
としつき	年月	time, years
ねんげつ	年月	years, time
ねんど	年度	year, school year
としより	年寄り	old person, older councilor
ねんし	年始	beginning of the year
ねんしゅう	年収	annual income
ねんだい	年代	age, date
ねんじゅう	年中	all year
としした	年下	younger, junior
としうえ	年上	older, senior
ねんねん	年々	year by year, annually
とし	年	year, age
へいめん	平面	level surface, plain
へいや	平野	plain, open field
へいこう	平行	parallel, side by side
びょうどう	平等	equality, impartiality
へいき	平気	nonchalant, calm
へいじつ	平日	weekday
へいほう	平方	square
へいせい	平成	Heisei era
へいきん	平均	average, equilibrium
へいわ	平和	peace, harmony
へいぼん	平凡	common, ordinary
ひらがな	平仮名	hiragana
たいら	平ら	flat, level
ひらたい	平たい	flat, level
ほす	干す	dry, desiccate
まく	幕	curtain
はばひろい	幅広い	wide, broad
はば	幅	width, breadth
ぼうし	帽子	cap, hat
じょうしき	常識	common sense, common knowledge
つねに	常に	always, at all times
きせい	帰省	homecoming
きたく	帰宅	return home
きこく	帰国	return to one's country
かえる	帰る	return, go back
かえり	帰り	return, going home
かえす	帰す	send home, see out
おび	帯	belt, sash
せき	席	seat, one's place
しわす	師走	December
きぼう	希望	hope, wish
ふとん	布団	futon, bedquilt
ぬの	布	cloth
しちょう	市長	mayor
しがい	市街	the streets, downtown
しりつ	市立	municipal, city
しみん	市民	citizens, townsmen
しやくしょ	市役所	municipal office, city hall
しがい	市外	city outskirts, suburbs
いちば	市場	market, marketplace
しじょう	市場	market, exchange
しない	市内	in the city
し	市	city
まく	巻く	roll up, wind, wrap
さべつ	差別	discrimination
さす	差す	open (an umbrella)
さしだす	差し出す	submit, stretch out
さしあげる	差し上げる	respectfully give
さ	差	difference
きょだい	巨大	huge, gigantic
ひだりて	左手	left hand
さゆう	左右	right and left
ひだりきき	左利き	left-handedness, left-hander
ひだりがわ	左側	left side
ひだり	左	left
こうぎょう	工業	industry, manufacturing industry
こうがくぶ	工学部	department of engineering
こうがく	工学	engineering
くふう	工夫	contrivance, scheme
こうじょう	工場	factory, plant
こうじ	工事	construction
す	巣	nest, den
めぐる	巡る	go round, circulate
しゅう	州	state
かわ	川	river, stream
あらし	嵐	storm
くずれる	崩れる	crumble, collapse
くずす	崩す	destroy, break
がけ	崖	cliff
しま	島	island, isle
とう	島	island
とうげ	峠	mountain pass, ridge
きし	岸	shore, bank
いわ	岩	rock, crag
さんみゃく	山脈	mountain range
やまのぼり	山登り	mountain climbing
やま	山	mountain
はきもの	履物	footwear
りれきしょ	履歴書	resume, bio
りれき	履歴	history, personal history
はく	履く	put on footwear, wear
ぞくする	属する	belong to, be one of
てんかい	展開	unfolding, development
てんらんかい	展覧会	exhibition
くず	屑	waste, scraps
やね	屋根	roof
おくじょう	屋上	housetop, roof
とどける	届ける	deliver, give notice
とどけ	届け	report, delivery
とどく	届く	reach, be received
いま	居間	living room
いねむり	居眠り	doze, nap
いる	居る	be present
おる	居る	be present, stay (humble)
きょく	局	bureau, public service office
お	尾	tail
しゅうしょく	就職	finding employment
しゅうにん	就任	inauguration, appointment
つく	就く	set about a task, enter upon
しょうりょう	少量	small quantity
しょうすう	少数	small number, minority
しょうねん	少年	boy
しょうじょ	少女	girl
すくなくとも	少なくとも	at least
すくない	少ない	few, little
すこしも	少しも	at all
すこし	少し	a bit, a little while
しょうしょう	少々	a little, a few
しょうしょう	少々	a little, a few
こむぎこ	小麦粉	flour
こむぎ	小麦	wheat
ことり	小鳥	small bird
こさめ	小雨	drizzle
しょうりょう	小量	small amount
こづかい	小遣い	pocket money, spending money
しょうせつ	小説	novel, story
しょうすう	小数	decimal
こゆび	小指	little finger, little toe
おがわ	小川	brook, stream
しょうがくせい	小学生	schoolchildren, schoolboy
しょうがっこう	小学校	elementary school
こうりてん	小売店	retail store, outlet
こがた	小型	small-sized
こづつみ	小包	parcel, package
しょうにか	小児科	pediatrics
しょうべん	小便	urine, pee
ちいさい	小さい	small
しょう	小	smallness, small size
どうにゅう	導入	introduction
みちびく	導く	guide, lead
たずねる	尋ねる	inquire, search for
そんけい	尊敬	respect, esteem, honor
しょうらい	将来	future, in the future
さす	射す	shine on
せんもんか	専門家	specialist, expert
せんもん	専門	specialty, profession
せんよう	専用	exclusive use, private use
せんこう	専攻	major, specialization
ふうとう	封筒	envelope
ふう	封	seal, sealing
じゅみょう	寿命	life span
すし	寿司	sushi
たいしょう	対象	target, object
たいだん	対談	interview
たいわ	対話	dialogue, conversation
たいさく	対策	measure, action
たいとう	対等	equality, parity
たいりつ	対立	opposition, antagonism
たいひ	対比	contrast, comparison
たいおう	対応	correspondence, equivalence
たいする	対する	face, be in response to
つい	対	pair
てら	寺	buddhist temple
りょう	寮	dormitory, lodging house
しんぎ	審議	deliberation, consideration
ねすごす	寝過ごす	oversleep
ねころぶ	寝転ぶ	lie down
しんしつ	寝室	bedroom
ねぼう	寝坊	late riser, oversleeping
ねる	寝る	sleep, go to sleep
ねかせる	寝かせる	put to bed, lay down
ねかす	寝かす	put to sleep
さむけ	寒気	chill
かんだんけい	寒暖計	thermometer
さむさ	寒さ	coldness, cold
さむい	寒い	cold (temperature of the air)
とむ	富む	be rich, abound in
ひそか	密か	secret, private
よる	寄る	stop by, stop off
よりあつまる	寄り集まる	gather, assemble
よりみち	寄り道	dropping by, going out of the way
よりかかる	寄り掛かる	lean against something
よせる	寄せる	draw near, draw up, gather
さびしい	寂しい	lonely, desolate, sad
しゅくだい	宿題	homework
ようい	容易	easy, simple
ようき	容器	receptacle, container
やちん	家賃	rent
かけい	家計	family finances
かぞく	家族	family, household
かてい	家庭	home, family
かおく	家屋	house, building
いえで	家出	running away from home
かない	家内	my wife
かぐ	家具	furniture
かじ	家事	housework, domestic duties
やぬし	家主	landlord
いえ	家	house, home
うち	家	house, home
がい	害	harm, damage
しつない	室内	indoors
せんでん	宣伝	publicity, advertisement
きゃくま	客間	guest room, parlor
きゃっかんてき	客観的	objective
きゃくせき	客席	seat, passenger seat
きゃく	客	visitor, customer
じっけん	実験	experiment
じっさい	実際	truth, actual state
じっこう	実行	practice, execution
じっしゅう	実習	practice, training
じっせき	実績	achievement, performance
じつようてき	実用的	practical
じつよう	実用	practical use, utility
じつげん	実現	implementation, realization
じつぶつ	実物	real thing, actual object
じっし	実施	enforcement, implementation
じったい	実態	the actual situation, the realities
じっかん	実感	true sense, realization
じつりょく	実力	real ability, capability
じつれい	実例	example, instance
みのる	実る	bear fruit, ripen
じつは	実は	actually
じつに	実に	truly, surely
み	実	fruit, nut
ほうせき	宝石	gem, jewel
あてな	宛名	name of recipient, addressee
あてさき	宛先	recipient, addressee
ていしょく	定食	day's special, set menu
ていぎ	定義	definition
ていきけん	定期券	commuter's pass
ていき	定期	fixed term, regular
ていねん	定年	mandatory retirement age
ていいん	定員	fixed staff number, capacity
ていか	定価	fixed price
ていきゅうび	定休日	regular holiday
さだめる	定める	fix, determine
かんちょう	官庁	government office
しゅうきょう	宗教	religion
かんせい	完成	completion, finish
かんぜん	完全	perfect, complete
かんりょう	完了	completion
あんしん	安心	peace of mind, relief
あんてい	安定	stability, composure
やすうり	安売り	sale
あんぜん	安全	safety, security
やすっぽい	安っぽい	cheap, tacky
やすい	安い	inexpensive, cheap
しゅび	守備	defense, fielding
まもる	守る	protect, observe
うちゅう	宇宙	universe, space
まご	孫	grandchild
がくちょう	学長	college president
がくぶ	学部	faculty, department
がくひ	学費	school expenses, tuition
がくせつ	学説	theory
がくしゃ	学者	scholar
がくしゅう	学習	study, learning
がっか	学科	subject, department
がくせい	学生	student
がくれき	学歴	educational history
がっこう	学校	school
がっき	学期	school term
がくねん	学年	school year, grade
がくえん	学園	educational institution, school
がくもん	学問	learning, scholarship
がくりょく	学力	scholastic performance, academic ability
がくわり	学割	student discount
がっかい	学会	academic association, academic conference
まなぶ	学ぶ	learn, study
こどく	孤独	solitary, lonely
きせつ	季節	season
そんざい	存在	existence, being
ぞんじる	存じる	think, know
じびき	字引	dictionary
じ	字	character, letter
しそん	子孫	descendant, offspring
こども	子供	child, kid
こ	子	child, kid
うれしい	嬉しい	happy, glad
いやがる	嫌がる	dislike, hate
きらう	嫌う	dislike
きらい	嫌い	dislike
いや	嫌	dislike, have a dislike for
よめ	嫁	bride, daughter-in-law
ふじん	婦人	woman, lady
こんやく	婚約	engagement, betrothal
ばあさん	婆さん	grandmother, old lady
ごらく	娯楽	amusement, pastime
むすめ	娘	daughter, girl
いばる	威張る	put on airs, be arrogant
しせい	姿勢	posture, attitude
すがた	姿	figure, appearance
めい	姪	niece
いいんかい	委員会	committee
いいん	委員	committee member, delegate
せいめい	姓名	full name
せい	姓	surname, family name
しじゅう	始終	from beginning to end, at all times
しはつ	始発	first departure
はじめる	始める	begin, start
はじめに	始めに	in the beginning, early in
はじめ	始め	beginning, origin
はじまる	始まる	begin
はじまり	始まり	beginning
しまい	姉妹	sisters
ねえさん	姉さん	older sister, girl, miss
あね	姉	older sister
つま	妻	wife
いもうと	妹	younger sister
ぼうがい	妨害	hindrance, obstruction
にんしん	妊娠	pregnancy, conception
こうちょう	好調	favorable condition
こうい	好意	favor, affection
こうきしん	好奇心	curiosity
このむ	好む	like, be fond of
このみ	好み	taste, preference
すききらい	好き嫌い	likes and dislikes, taste
すき	好き	favorite, liked
にょうぼう	女房	wife
じょせいてき	女性的	feminine, womanly
じょせい	女性	woman, female
じょし	女子	woman, girl
じょゆう	女優	actress
おんならしい	女らしい	womanly, feminine
おんなのこ	女の子	girl, daughter
おんな	女	woman, girl
うばう	奪う	rob, take by force
しょうがくきん	奨学金	scholarship, fellowship
おくさま	奥様	married woman, someone's wife
おくさん	奥さん	married lady, your wife
おく	奥	inner part, the back, inner chamber
けいやく	契約	contract, agreement
きれい	奇麗	beautiful
きせき	奇跡	miracle, wonder
きすう	奇数	odd number
しつれい	失礼	impoliteness, bad manners, I beg your parden/Goodbye
しつぎょう	失業	unemployment, loss of job
しつぼう	失望	disappointment, loss of hope
しっぱい	失敗	failure, mistake
しつれん	失恋	broken heart
うしなう	失う	lose, miss
ふうふ	夫婦	husband and wife, married couple
ふさい	夫妻	husband and wife, Mr. and Mrs.
ふじん	夫人	wife, married lady
おっと	夫	husband
たいよう	太陽	sun
ふとる	太る	grow fat, fatten
ふとい	太い	thick, fat
てんのう	天皇	emperor
てんねん	天然	nature
てんさい	天災	natural disaster
てんきよほう	天気予報	weather forecast
てんき	天気	weather
てんさい	天才	genius
てんごく	天国	paradise
てんこう	天候	weather, climate
てんじょう	天井	ceiling
あまのがわ	天の川	Milky Way
てん	天	sky, Heaven
おおむぎ	大麦	barley
おおゆき	大雪	heavy snow
おおあめ	大雨	heavy rain
たいりく	大陸	continent
たいきん	大金	large sum of money
たいりょう	大量	large quantity, great volume
だいぶぶん	大部分	most, greater part
おおどおり	大通り	main street
たいしゅう	大衆	the masses, the populace
おおくらしょう	大蔵省	Ministry of Finance
だいじん	大臣	minister
だいたん	大胆	boldness, daring
だいとうりょう	大統領	president (of a country)
おおみず	大水	flood, inundation
たいしょう	大正	Taisho era
たいがい	大概	generally, probably
だいこん	大根	daikon radish, oriental radish
おおみそか	大晦日	new year's eve
たいてい	大抵	generally, mostly
おおて	大手	major companies
たいせん	大戦	world war
おおいそぎ	大急ぎ	in a great hurry
おおはば	大幅	drastically, substantially
だいく	大工	carpenter
たいそう	大層	very, highly
だいしょう	大小	size
おおや	大家	landlord
だいがくいん	大学院	graduate school
だいがくせい	大学生	university student
だいがく	大学	university, college
だいきらい	大嫌い	hate
だいすき	大好き	love
たいへん	大変	awful, serious
おおごえ	大声	loud voice
おおがた	大型	large, large scale
たいこく	大国	world power, large country
おおよろこび	大喜び	great joy, delight
おおぜい	大勢	large numbers, a lot of
たいせつ	大切	important, valuable
だいぶ	大分	very, greatly
だいべん	大便	stool, feces
たいしかん	大使館	embassy
たいし	大使	ambassador
だいたい	大体	outline, generally
たいかい	大会	mass meeting, tournament
おとなしい	大人しい	gentle, quiet, subdued
おとな	大人	adult
おとな	大人	adult
だいじ	大事	importance
だいじょうぶ	大丈夫	alright, OK
たいして	大して	very, greatly
おおげさ	大げさ	exaggerate
おおきさ	大きさ	size, dimensions
おおきい	大きい	big
おおいに	大いに	very, greatly
だい	大	bigness, large size
むちゅう	夢中	be absorbed
ゆめ	夢	dream
やかん	夜間	night, nighttime
よぞら	夜空	night sky
よふかし	夜更かし	sitting up late at night
よあけ	夜明け	dawn, daybreak
よなか	夜中	midnight, dead of night
よる	夜	night (from sunset to sunrise)
よ	夜	night, evening
たりょう	多量	large quantity, great deal
たすう	多数	large number, multitude
たぼう	多忙	very busy
たしょう	多少	a little, somewhat
たぶん	多分	probably, perhaps
おおく	多く	much, largely
おおい	多い	lots of
がいしょく	外食	eating out, dining out
がいぶ	外部	outside, outer
がいか	外貨	foreign currency
がいかん	外観	external appearance
げか	外科	surgery
がいしょう	外相	Minister of Foreign Affairs
がいらいご	外来語	loanword, foreign word
がいこくご	外国語	foreign language
がいこくじん	外国人	foreigner
がいこく	外国	foreign country
がいむしょう	外務省	Ministry of Foreign Affairs
がいしゅつ	外出	outing
そとがわ	外側	exterior, outside
がいじん	外人	foreigner, alien
がいこう	外交	diplomacy, foreign relations
はずれる	外れる	come off
はずれ	外れ	blank
はずす	外す	remove
そと	外	outside, open air
ゆうはん	夕飯	evening meal, supper
ゆうしょく	夕食	supper
ゆうだち	夕立	sudden evening shower
ゆうやけ	夕焼け	sunset glow
ゆうぐれ	夕暮れ	evening, twilight
ゆうひ	夕日	setting sun
ゆうがた	夕方	evening
ゆうかん	夕刊	evening edition
かき	夏季	summer, summer season
なつやすみ	夏休み	summer vacation
なつ	夏	summer
へんこう	変更	alteration, change
へんかん	変換	change, conversion
へんか	変化	change
かわる	変わる	change
かえる	変える	change
へん	変	strange, weird, funny
ばいばい	売買	buying and selling, trade
ばいてん	売店	booth, store
うれる	売れる	sell, be in demand
うる	売る	sell
うりば	売り場	sales floor, department
うりきれる	売り切れる	be sold out, go out of stock
うりきれ	売り切れ	sellout, sold out
うりだす	売り出す	put on sale
うりあげ	売り上げ	sales, proceeds
こえ	声	voice, sound
こわれる	壊れる	break, break down, get out of order
こわす	壊す	break, destroy, smash
かべ	壁	wall, partition
すみ	墨	black ink
ついらく	墜落	fall, crash
ぞうげん	増減	increase and decrease, rise and fall
ぞうだい	増大	increase, enlargement
ぞうか	増加	increase, gain
ふやす	増やす	increase, add
ます	増す	increase, augment
ふえる	増える	increase, accrue
ぼち	墓地	graveyard, cemetery
はかまいり	墓参り	visit to a grave
はか	墓	grave, gravestone
きょうかい	境界	boundary, border
さかい	境	boundary, border
しおからい	塩辛い	salty
しお	塩	salt
ふさぐ	塞ぐ	close, shut
ふさがる	塞がる	close up
ぬる	塗る	spread on, paint
とう	塔	tower, pagoda
かたまり	塊	lump, ingot
へい	塀	fence, wall
ばめん	場面	scene, situation
ばしょ	場所	place, space
ばあい	場合	situation, case
ば	場	opportunity, occasion
ほうしゅう	報酬	remuneration, reward
ほうどう	報道	news, report
ほうこく	報告	report
きそ	基礎	basis, foundation
きじゅん	基準	standard, criterion
きじゅん	基準	standard, criterion
きほん	基本	basis, foundation
きち	基地	base, military base
もとづく	基づく	be based on
しろ	城	castle, fort
うめる	埋める	bury, fill up
うずめる	埋める	bury, fill in
かた	型	type, mold
すいちょく	垂直	vertical, perpendicular
ぼうさん	坊さん	Buddhist priest
さか	坂	slope, incline
じめん	地面	surface, ground
じしん	地震	earthquake
ちり	地理	geography
ちきゅう	地球	the Earth
じごく	地獄	hell, inferno
ちてん	地点	spot, point
ちほう	地方	district, region
ちけい	地形	geographical features, topography
ちへいせん	地平線	horizon
ちたい	地帯	zone, area
ちいき	地域	region, area
ちず	地図	map, atlas
じみ	地味	plain, sober
ちめい	地名	place name
ちか	地価	price of land
ちい	地位	position, status
ちかてつ	地下鉄	subway
ちかどう	地下道	underpass, underground passage
ちか	地下	underground
ちじょう	地上	above ground
ち	地	ground, place
ざいがく	在学	attendance at school
あつりょく	圧力	pressure
みやげ	土産	souvenir
どようび	土曜日	Saturday
とち	土地	land
つち	土	soil, ground
こくさいてき	国際的	international
こくさいか	国際化	internationalization
こくさい	国際	international
こくてつ	国鉄	Japan National Railways
こくどう	国道	national highway
こくれん	国連	United Nations
こくひ	国費	national expenditure
こくご	国語	national language, Japanese
こくせき	国籍	nationality, citizenship
こくりつ	国立	national
こくさん	国産	domestically produced
こくみん	国民	the people, nation
こっき	国旗	national flag
こっか	国家	state, country
こくがい	国外	abroad, outside the country
こっきょう	国境	national border
こくど	国土	country, territory
こくめい	国名	country name
こくない	国内	domestic, internal
こっかい	国会	National Diet, parliament
こっこう	国交	diplomatic relations, national friendship
くにぐに	国々	nations, countries
くに	国	country
こゆう	固有	peculiar to, characteristic
こてい	固定	fixing, stability
こたい	固体	solid, solid matter
かためる	固める	harden, strengthen
かたまる	固まる	harden, solidify
かたい	固い	stiff, tight
としょかん	図書館	library
としょしつ	図書室	library
としょ	図書	books
はかる	図る	strive for, attempt
ず	図	figure, map
いご	囲碁	game of "go"
かこむ	囲む	enclose, encircle
こんなん	困難	difficulty, hardship
こまる	困る	be at a loss, in a jam, in trouble
だんち	団地	housing estate, housing complex
だんたい	団体	group, corporation
よる	因る	be caused by, be due to
かいてん	回転	revolution, rotation
かいろ	回路	circuit
かいとう	回答	reply, answer
かいすうけん	回数券	book of tickets
かいすう	回数	frequency, number of times
かいふく	回復	recovery, rehabilitation
まわる	回る	turn round, go round, detour
まわりみち	回り道	roundabout way, detour
まわり・まわり	回り・周り	vicinity, whereabouts
まわす	回す	turn, rotate
しかくい	四角い	square, four-sided
しかく	四角	square, quadrilateral
よっか	四日	four days, 4th of the month
しほう	四方	all directions, far and wide
しき	四季	the four seasons
よつかど	四つ角	street corner, intersection
よっつ	四つ	four (things)
し	四	four
よん	四	four
ささやく	囁く	whisper
ふんか	噴火	eruption, volcanic activity
ふんすい	噴水	jet, fountain
きよう	器用	skillful, clever
きかい	器械	instrument, apparatus
きぐ	器具	utensil, implement
うつわ	器	vessel, dish
かむ	噛む	bite, chew
かみつく	噛み付く	bite at
うわさ	噂	gossip, rumor
うそつき	嘘つき	liar
うそ	嘘	lie
なげく	嘆く	sigh, grieve
かぐ	嗅ぐ	smell, sniff
えいぎょう	営業	business, sales
きっさてん	喫茶店	coffee shop, tea house, café
きつえん	喫煙	smoking
けんか	喧嘩	fight, quarrel, argument
きげき	喜劇	comedy
よろこぶ	喜ぶ	be happy, be delighted
よろこび	喜び	joy, happiness
よろこばす	喜ばす	please, gladden
のど	喉	the throat
もんだい	問題	problem, question
もんどう	問答	questions and answers, argument
とんや	問屋	wholesale store, wholesaler
とう	問う	ask, question
といあわせる	問い合わせる	inquire, contact
とい	問い	question, inquiry
しょうしゃ	商社	trading firm
しょうぎょう	商業	commerce, trade
しょうてん	商店	shop, store
しょうばい	商売	trade, business
しょうひん	商品	goods, commodities
しょうにん	商人	merchant, trader
つば	唾	saliva, spittle
くちびる	唇	lip, lips
てつがく	哲学	philosophy
ひんしつ	品質	quality
しなもの	品物	article, thing
しなぎれ	品切れ	run out, sell out
しな	品	article, item
せき	咳	cough
さく	咲く	bloom, blossom
わしょく	和食	Japanese-style food
わふう	和風	Japanese style
わご	和語	native Japanese word
わえい	和英	Japanese-English
わふく	和服	Japanese clothes, kimono
わしき	和式	Japanese style
わしつ	和室	Japanese style room
やわらげる	和らげる	soften, relieve
やわらぐ	和らぐ	soften, calm down
なごやか	和やか	peaceful, mild
めいれい	命令	command, order
めいじる	命じる	order, give orders
いのち	命	life
こきゅう	呼吸	breathing, respiration
よぶ	呼ぶ	call, name
よびかける	呼び掛ける	call to, appeal to
よびだす	呼び出す	call, page
みかた	味方	friend, ally
みそしる	味噌汁	miso soup
みそ	味噌	miso, soybean paste
あじわう	味わう	taste, appreciate
あじ	味	taste, flavor
しゅうへん	周辺	environs, circumference
しゅうい	周囲	circumference, surroundings
ふく	吹く	blow, play on a wind instrument
きゅうしゅう	吸収	absorption, merger
すう	吸う	inhale, suck
すいこむ	吸い込む	inhale, suck in
ふくめる	含める	include
ふくむ	含む	contain, include
ひてい	否定	denial, negation
ほえる	吠える	bark, bay
きみ	君	you
こうじょう	向上	improvement
むこうがわ	向こう側	other side
むこう	向こう	the other side, the other party, opponent
むける	向ける	turn toward, point at
むく	向く	turn, face, look
むき	向き	direction, turn
むかう	向かう	face, confront, head toward
むかい	向かい	opposite side
はく	吐く	holler, spew
めいし	名詞	noun
めいぼ	名簿	registry, name list
めいしょう	名称	name
めいぶつ	名物	specialty, noted product
なふだ	名札	name badge, tag
めいしょ	名所	noted place, sights
みょうじ	名字	surname, family name
なまえ	名前	name
めいし	名刺	business card, calling card
なづける	名付ける	name, give a name to
めいじん	名人	master, master hand
な	名	name, reputation
どうきゅうせい	同級生	classmate
どうとう	同等	equality
どうよう	同様	similar
どうじ	同時	simultaneous
どうい	同意	consent, approval
どうじょう	同情	sympathy, compassion
どうせい	同性	of the same sex
どうきょ	同居	living together
どうふう	同封	enclosure
どうせい	同姓	same surname
どうし	同士	fellow, to each other
どういつ	同一	sameness, identity
おなじ	同じ	same, identical
つるす	吊るす	hang
ごうけい	合計	sum total
ごうりてき	合理的	rational, logical
ごうかく	合格	passing an examination, eligibility
ごうせい	合成	composition, synthesis
ごうい	合意	mutual agreement
あいず	合図	signal, sign
がっしょう	合唱	chorus
ごうどう	合同	combination, joint
あわせる	合わせる	adjust, match
あわす	合わす	match, add
あう	合う	fit
かくじ	各自	each one, every individual
かくしゅ	各種	each kind, various
かくち	各地	every place, various parts
かっこく	各国	every country
しかい	司会	master of ceremonies, host
みぎて	右手	right hand
みぎがわ	右側	right side
みぎ	右	right
しかる	叱る	scold, tell off, reprimand
たいふう	台風	typhoon
だいどころ	台所	kitchen
だい	台	stand, platform
かのう	可能	possible, potential
かわいらしい	可愛らしい	lovely, charming
かわいがる	可愛がる	love, cherish
かわいい	可愛い	cute, charming, sweet
かわいそう	可哀相	poor, pitiable
か	可	permitted, OK
めしあがる	召し上がる	eat, drink
さけぶ	叫ぶ	shout, cry out
さけび	叫び	shout, cry
たたく	叩く	tap, hit
く	句	phrase, clause
ふるさと	古里	hometown, birthplace
ふるほん	古本	secondhand book
こてん	古典	classics
こだい	古代	ancient times, antiquity
ふるい	古い	old
くちべに	口紅	lipstick, rouge
くちげんか	口げんか	quarrel
くち	口	mouth
じゅけん	受験	take an examination
じゅわき	受話器	receiver
うけつけ	受付	receptionist, information office
うけみ	受け身	passiveness, passive voice
うけとめる	受け止める	catch, receive
うけもつ	受け持つ	have charge of
うけとる	受け取る	receive, understand
うけとり	受け取り	receipt
うけいれる	受け入れる	accept, accommodate
うけつける	受け付ける	receive, accept
うける	受ける	receive, accept
うかる	受かる	pass
とりけし	取消し	cancellation, annulment
しゅざい	取材	collection of data, gathering of news
とりひき	取引	transaction, dealings
とれる	取れる	come off, be removed
とれる	取れる	be harvested, be cultivated
とる	取る	take, get
とりかえす	取り返す	take back, regain
とりしまる	取り締まる	control, crack down
とりしまり	取り締まり	regulation, crackdown
とりくむ	取り組む	grapple, pursue
とりけす	取り消す	cancel, nullify
とりきめ	取り決め	decision, agreement
とりつぐ	取り次ぐ	relay a message, transfer a call
とりかえる	取り替える	change, replace
とりあえず	取り敢えず	for now, first of all
とりあつかう	取り扱う	handle, deal in
とりあつかい	取り扱い	handling, manipulation
とりもどす	取り戻す	take back, recover
とりだす	取り出す	take out, pull out
とりいれる	取り入れる	take in, adopt
とりあげる	取り上げる	take up, confiscate
しゅうしゅう	収集	collection, gathering
しゅうかく	収穫	harvest, harvesting
しゅうし	収支	earnings and expenses
しゅうにゅう	収入	income, earnings
はんろん	反論	objection, counterargument
はんせい	反省	reflection, repentance
はんぱつ	反発	reaction, backlash
はんえい	反映	reflection
はんかん	反感	ill feeling, antipathy
はんのう	反応	reaction, response
はんしゃ	反射	reflection
はんたい	反対	oppose, object
はんそく	反則	foul, rule violation
はんする	反する	oppose, act contrary to
ふたご	双子	twins
ともだち	友達	friend, companion
ゆうじょう	友情	friendship
ゆうじん	友人	friend
とも	友	friend, companion
およぶ	及ぶ	reach to, come up to
また	又	again, also, or
さんぎいん	参議院	House of Councilors, Upper House
さんこうしょ	参考書	reference book
さんこう	参考	reference, consultation
さんか	参加	participation
まいる	参る	go, come
きょねん	去年	last year
さる	去る	go away, leave
げんじゅう	厳重	strict, secure
きびしい	厳しい	strict, severe, intense
げんこうようし	原稿用紙	manuscript paper, writing pad
げんり	原理	principle, theory
げんりょう	原料	raw material
げんしりょく	原子力	atomic energy, nuclear power
げんいん	原因	cause, origin
げんそく	原則	principle, general rule
はら	原	plain, field
あつぎ	厚着	heavy clothing
あつさ	厚さ	thickness
あつい	厚い	thick, bulky
たまご	卵	egg
きけん	危険	danger, dangerous
きき	危機	crisis, emergency
あぶない	危ない	dangerous, uncertain
いんかん	印鑑	personal seal
いんしょう	印象	impression
いんさつ	印刷	printing
しるし	印	mark, symbol
しめる	占める	occupy, hold
はくぶつかん	博物館	museum
はかせ	博士	expert, doctor
はくし	博士	Ph.D.
たんちょう	単調	monotonous, dull
たんご	単語	word
たんじゅん	単純	simple, uncomplicated
たんすう	単数	singular
たんい	単位	unit, credit
たんに	単に	merely, simply
なんせい	南西	southwest
なんきょく	南極	South Pole
なんとう	南東	southeast
なんぼく	南北	north and south
みなみ	南	south
きょうぎ	協議	conference, deliberation
きょうりょく	協力	cooperation, collaboration
そつぎょう	卒業	graduation
ひきょう	卑怯	cowardice, meanness
いやしい	卑しい	mean, greedy
はんめん	半面	profile, one side
はんそで	半袖	short-sleeved shirt
はんつき	半月	half a month
はんにち	半日	half a day
はんけい	半径	radius
はんとし	半年	half a year
はんとし	半年	half a year
はんとう	半島	peninsula
はんどうたい	半導体	semiconductor
はんぶん	半分	half
なかば	半ば	middle, halfway
ごご	午後	afternoon, p.m.
ごぜん	午前	morning, a.m.
せん	千	thousand
とおか	十日	ten days, 10th of the month
じゅうじろ	十字路	crossroads
じゅうぶん	十分	full, plentiful
じゅう	十	ten
いしゃ	医者	doctor
いりょう	医療	medical service, healthcare
いし	医師	doctor, physician
いがく	医学	medical science, medicine
くかく	区画	division, section
くやくしょ	区役所	ward office
くいき	区域	zone
くべつ	区別	distinction, classification
くぎる	区切る	punctuate, divide
くぶん	区分	division, section
く	区	ward
きたかぜ	北風	north wind
ほくせい	北西	northwest
ほっきょく	北極	North Pole
ほくとう	北東	northeast
きた	北	north
けしょう	化粧	make up, put on makeup
かがく	化学	chemistry
ほうたい	包帯	bandage, dressing
ほうちょう	包丁	kitchen knife, carving knife
つつむ	包む	wrap, pack
つつみがみ	包み紙	wrapping paper
つつみ	包み	package, parcel
におう	匂う	smell (pleasant)
におい	匂い	smell, odor
すすめる	勧める	suggest, recommend
きんむ	勤務	duty, service
きんべん	勤勉	diligence, hard work
きんろう	勤労	labor, work
つとめさき	勤め先	employment
つとめる	勤める	serve, hold a job
つとめ	勤め	service, duties
せいりょく	勢力	influence, power
いきおい	勢い	vigor, momentum
ぼしゅう	募集	recruitment, collection
しょうぶ	勝負	match
しょうはい	勝敗	victory or defeat
かって	勝手	selfish, self-centered
かつ	勝つ	win
かち	勝ち	win, victory
つとめる	務める	perform a duty, play a role
つとめ	務め	duty, task
かんちがい	勘違い	misunderstanding
かんじょう	勘定	check, tab
かん	勘	sense, intuition
どうし	動詞	verb
どうぶつえん	動物園	zoo
どうぶつ	動物	animal
どうこう	動向	trend, tendency
どうりょく	動力	power
どうさ	動作	movements, actions
うごく	動く	move
うごき	動き	movement, motion
うごかす	動かす	move, operate
べんきょう	勉強	study
ゆうき	勇気	courage, nerve
ゆうかん	勇敢	brave, heroic
こうりつ	効率	efficiency
こうか	効果	effect, result
こうりょく	効力	effect, validity
きく	効く	be effective
ききめ	効き目	effect, efficacy
ろうりょく	労力	labor, work
ろうどうしゃ	労働者	laborer, worker
ろうどう	労働	labor, toil
はげます	励ます	encourage, urge
どりょく	努力	endeavor, effort
つとめる	努める	endeavor, make efforts, try hard
じょし	助詞	particle, postposition
じょしゅ	助手	assistant, helper
たすける	助ける	help, save
たすかる	助かる	be helped, be rescued
おとる	劣る	be inferior to, be worse than
かこう	加工	processing, manufacturing
くわわる	加わる	join in
くわえる	加える	add, include
ちからづよい	力強い	powerful, vigorous
ちから	力	strength, power
げきじょう	劇場	theater
げき	劇	drama, play
そうりつ	創立	establishment, organization
わりあいに	割合に	relatively, rather
わりあい	割合	rate, proportion
われる	割れる	crack, be divided, split
わる	割る	divide, crack, split
わりこむ	割り込む	cut in
わりばし	割り箸	disposable chopsticks
わりざん	割り算	division
わりあてる	割り当てる	assign, allot
わりあて	割り当て	assignment, allotment
わりびく	割り引く	give a discount, make a reduction
わりびき	割り引き	discount, reduction
わり	割り	rate
わりに	割に	comparatively, rather
ふくし	副詞	adverb
ぜんしん	前進	advancement
ぜんしゃ	前者	the former
ぜんき	前期	previous term, last semester
ぜんぽう	前方	front
ぜんてい	前提	assumption, premise
ぜんご	前後	before and after, order
ぜんねん	前年	the year before
まえうりけん	前売り券	advance ticket
ぜんかい	前回	last time
まえむき	前向き	facing forward, positively
ぜんはん	前半	first half
まえもって	前もって	in advance
まえ	前	front, before
さくじょ	削除	deletion, elimination
さくげん	削減	curtailment, reduction
けずる	削る	grind down, trim, scale back
そる	剃る	shave
きざむ	刻む	cut fine
さしみ	刺身	sashimi, sliced raw meat
しげき	刺激	stimulus, stimulation
さす	刺す	stab, prick, sting
ささる	刺さる	stick, be stuck
けん	券	voucher, ticket
せいげん	制限	restriction, limit
せいふく	制服	uniform
せいぎょ	制御	control, command
せいど	制度	system, organization
とうたつ	到達	arrival, attainment
とうちゃく	到着	arrival
とうてい	到底	after all, in the long run
りえき	利益	profit, benefit
りよう	利用	utilization, usage
りそく	利息	interest
りし	利子	interest
りこう	利口	clever, bright
きく	利く	work, function
わかれる	別れる	separate, part from
わかれ	別れ	separation, parting
べつに	別に	especially, particularly
べつべつ	別々	separately
べつ	別	another, different
はんけつ	判決	judicial decision, judgment
はんだん	判断	judgment, decision
はんこ	判子	seal, stamp
はつもうで	初詣で	first shrine visit of the new year
しょきゅう	初級	beginner class, elementary level
しょほ	初歩	first steps, beginning
しょき	初期	early days, initial
しょにち	初日	first day, opening day
はつこい	初恋	first love
しょか	初夏	early summer
はじめて	初めて	for the first time
はじめ	初め	beginning
れっしゃ	列車	train
れっとう	列島	archipelago
れつ	列	row, line
けいむしょ	刑務所	prison
けいじ	刑事	detective
きっぷ	切符	ticket
きって	切手	postage stamp
きれる	切れる	run out, expire, can cut
きれ	切れ	sharpness
きる	切る	cut
ぶんるい	分類	classification
ぶんり	分離	separation, split
ぶんや	分野	field, sphere
ぶんかい	分解	taking apart
ぶんれつ	分裂	division, split
ぶんせき	分析	analysis
ぶんさん	分散	dispersion
ぶんたん	分担	assigning tasks, sharing burden
わける	分ける	divide into parts, sort, share
わかれる	分かれる	be divided, disperse, branch off
わかる	分かる	understand
ぶん	分	amount, part, share
かたな	刀	sword, blade
でむかえ	出迎え	meeting, receiving
しゅっしん	出身	come from, origin
しゅっけつ	出血	bleeding, hemorrhage
しゅっか	出荷	shipping, dispatch
しゅっぱつ	出発	departure, starting
しゅっさん	出産	birth, delivery
しゅっぱんしゃ	出版社	publishing company
しゅっぱん	出版	publishing, publication
しゅつえん	出演	appearance on stage, performance
できごと	出来事	occurrence, incident
できあがる	出来上がる	be completed, be finished
できあがり	出来上がり	completion, finish
できるだけ	出来るだけ	as much as possible
できる	出来る	can do, be good at
でかける	出掛ける	go out, be about to go out
しゅっちょう	出張	business trip
しゅっせき	出席	attendance, presence
しゅつじょう	出場	participation
しゅっこく	出国	departure, emigration
でぐち	出口	exit, exit ramp
しゅっきん	出勤	to go to work, attendance at work
しゅつりょく	出力	output
でまえ	出前	home delivery of food
でいりぐち	出入り口	doorway, gateway
でいり	出入り	coming and going
であう	出会う	meet
しゅっせ	出世	success, promotion
でる	出る	go out, leave
だす	出す	take out
しょり	処理	management, process
こおる	凍る	freeze, congeal
すごい	凄い	wonderful, great, incredible
れいせい	冷静	cool, calm
れいぞうこ	冷蔵庫	refrigerator
れいたん	冷淡	cool, indifferent
れいぼう	冷房	air conditioning
れいとう	冷凍	freezing, cold storage
ひやす	冷やす	cool, chill
ひやかす	冷やかす	tease, jeer
さめる	冷める	cool off, subside
さます	冷ます	cool, let cool
つめたい	冷たい	cold (things, touch)
ひえこむ	冷え込む	get colder
ひえる	冷える	cool down, feel chilly
とうき	冬季	winter season
ふゆやすみ	冬休み	winter vacation
ふゆ	冬	winter
しゃしん	写真	photograph
うつる	写る	be taken, be seen through
うつす	写す	copy, photograph
じょうだん	冗談	joke
ぼうけん	冒険	adventure, risk
さいかい	再開	reopening, restart
さいせい	再生	playback
さらいしゅう	再来週	the week after next
さらいげつ	再来月	the month after next
さらいねん	再来年	the year after next
さいかい	再会	reunion
ふたたび	再び	again, a second time
えんだか	円高	appreciation of the yen
えん	円	yen
えん	円	circle
ないりく	内陸	inland, interior
ないかく	内閣	cabinet
ないぶ	内部	interior, inner parts
ないぞう	内臓	internal organs
ないしょ	内緒	secrecy, privacy
ないか	内科	internal medicine
ないしん	内心	back of one's mind, one's real intention
ないよう	内容	contents
うちがわ	内側	inside, interior
うち	内	inside
かねる	兼ねる	serve two functions, combine
てんけいてき	典型的	typical, representative
てんけい	典型	type, model
ぐあい	具合	condition, health
ぐたいてき	具体的	concrete, specific
へいたい	兵隊	soldier, troops
へいし	兵士	soldier
へいき	兵器	arms, weapon
きょうつうご	共通語	common language, lingua franca
きょうつう	共通	commonality
きょうさんしゅぎ	共産主義	Communism
きょうどう	共同	joint, commonality
ともに	共に	together, both
むいか	六日	six days, 6th of the month
むっつ	六つ	six (things)
ろく	六	six
こうかい	公開	opening (to the public)
こうしゅう	公衆	the public
こうりつ	公立	public
こうえん	公演	public performance
こうしき	公式	formal, official
こうへい	公平	impartiality, fairness
こうがい	公害	environmental pollution
こうえん	公園	park, public garden
こうむいん	公務員	public officer, government worker
こうきょう	公共	public society, community
やおや	八百屋	vegetable store, greengrocer
ようか	八日	eight days, 8th of the month
やっつ	八つ	eight (things)
はち	八	eight
ぜんめんてき	全面的	all-out, overall
ぜんぶ	全部	all, wholly
ぜんそくりょく	全速力	full speed, full steam
ぜんしん	全身	the whole body
ぜんぱん	全般	whole, general
ぜんぜん	全然	wholly, at all
ぜんこく	全国	the whole country
ぜんいん	全員	all members, entire staff
ぜんりょく	全力	all one's might, full capacity
ぜんたい	全体	whole, total
すべて	全て	all, entirely
まったく	全く	entirely, truly, indeed
にゅういん	入院	be hospitalized
にゅうもん	入門	initiation
にゅうせん	入選	acceptance, selection
にゅうし	入試	entrance examination
にゅうしゃ	入社	entering a company
にゅうよく	入浴	bathing
にゅうがく	入学	enter a school, matriculate
にゅうじょうけん	入場券	entrance ticket
にゅうじょう	入場	entrance, admission
にゅうこく	入国	entry into a country, immigration
にゅうりょく	入力	input, power input
いれもの	入れ物	receptacle, container
いれる	入れる	put in
はいる	入る	enter
いりぐち	入り口	entrance
とう	党	political party
じどう	児童	child, juvenile
めんきょしょう	免許証	license
めんきょ	免許	license, permit
めんぜい	免税	tax exemption
ひかる	光る	shine, emit light
ひかり	光	light, flash
せんとう	先頭	forefront, head
せんしゅう	先週	last week
せんぱい	先輩	senior, superior
せんたん	先端	edge, vanguard
さきほど	先程	some time ago, a little while ago
せんぞ	先祖	forefather, ancestor
せんせい	先生	teacher
せんげつ	先月	last month
せんじつ	先日	the other day, a few days ago
さきに	先に	before, ahead
まず	先ず	first
さき	先	ahead, first
きょうだい	兄弟	sibling
にいさん	兄さん	older brother
あに	兄	older brother
げんき	元気	healthy, energetic
げんき	元気	vigor, spirits
がんらい	元来	originally, essentially
がんたん	元旦	New Year's Day
がんじつ	元日	New Year's Day
もともと	元々	originally, by nature
もと	元	origin, source
ゆうしゅう	優秀	excellent, exceptional
ゆうしょう	優勝	victory, championship
すぐれる	優れる	be superior to, be fine
やさしい	優しい	gentle, kind
おく	億	hundred million
ぎしき	儀式	ceremony, ritual
ぼく	僕	I (young male)
はたらく	働く	work
はたらき	働き	work, function
けいこう	傾向	tendency, disposition
かたむける	傾ける	lean, cock (one's head)
かたむく	傾く	decline, go down
きずつける	傷付ける	wound, hurt
きずつく	傷付く	get injured, be hurt
いためる	傷める	damage, spoil
きず	傷	wound, scar
さいそく	催促	demand, urging
もよおす	催す	feel, experience
もよおし	催し	event, function
そなえる	備える	provide for, furnish
かさ	傘	umbrella, parasol
にせもの	偽物	sham, imitation
ぐうぜん	偶然	chance, accident
ぐうすう	偶数	even number
そくめん	側面	side, flank
けんこう	健康	healthy
けんこう	健康	health
けんぜん	健全	healthy, sound
ていでん	停電	power cut, power failure
ていしゃ	停車	stoppage
ていりゅうじょ	停留所	stop, station
ていし	停止	stop, suspension
へんけん	偏見	prejudice, biased view
かたよる	偏る	be one-sided, deviate
いだい	偉大	great, mighty
えらい	偉い	great, famous, eminent
ねだん	値段	price
ねうち	値打ち	value, worth
ねびき	値引き	discount
ねぎる	値切る	bargain, haggle
ねさげ	値下げ	price reduction
ねさがり	値下がり	fall in price
ねあげ	値上げ	price hike
ねあがり	値上がり	price rise
あたいする	値する	be worth, deserve
あたい	値	value, worth
ならう	倣う	copy, follow an example
しゃっきん	借金	borrowing money, debt
かりる	借りる	borrow
かり	借り	borrowing, debt
こうほ	候補	candidacy, candidate
とうさん	倒産	insolvency
たおれる	倒れる	fall over, succumb
たおす	倒す	bring down, overthrow, defeat
ばい	倍	double
こせい	個性	individuality
こじん	個人	individual
ここ	個々	individually, one at a time
そうこ	倉庫	warehouse, storehouse
おれ	俺	I, me
はいく	俳句	haiku
はいゆう	俳優	actor, actress
しゅうり	修理	repair, mending
しゅうせい	修正	correction, revision
しゅうりょう	修了	completion
しんらい	信頼	reliance, confidence
しんよう	信用	trust, credit
しんねん	信念	belief, conviction
しんごう	信号	signal, traffic light
しんこう	信仰	faith, religious belief
しんじる	信じる	believe, trust, have faith in
ほしょう	保障	guarantee, security
ほけん	保険	insurance
ほごしゃ	保護者	guardian, protector
ほご	保護	protection, safeguard
ほしょうにん	保証人	guarantor
ほしょう	保証	guarantee, warranty
ほいくえん	保育園	day-care center, nursery school
ほしゅ	保守	conservation, maintenance
ほぞん	保存	preservation, conservation
ほけん	保健	health, health care
たもつ	保つ	preserve, sustain
うながす	促す	hasten, urge
かかり	係	person in charge
びんせん	便箋	letter paper, stationery
べんじょ	便所	lavatory, bathroom
べんり	便利	convenience, handiness
たより	便り	news, correspondence
おかす	侵す	invade, violate
かかく	価格	price, cost
かち	価値	value, merit
いらい	依頼	request, commission
きょうきゅう	供給	supply, provision
れいだい	例題	example, exercise
れいぶん	例文	illustrative sentence, example
れいねん	例年	normal year, average year
れいがい	例外	exception
たとえる	例える	compare, liken
たとえば	例えば	for example
たとえ	例え	metaphor, simile
れい	例	example, precedent
しようにん	使用人	servant
しよう	使用	usage
つかう	使う	use
つかいみち	使い道	use, application
つかい	使い	errand
さくせい	作製	manufacture, production
さくしゃ	作者	author, writer
さよう	作用	action, effect
さくもつ	作物	crop
さぎょう	作業	work, operation
さっきょく	作曲	composition
さくぶん	作文	composition, essay
さくせん	作戦	tactic, strategy
さっか	作家	writer, novelist
さくひん	作品	work of art, piece
つくる	作る	make, create
つくりばなし	作り話	fable, fiction
つくりあげる	作り上げる	make up, build up
よけい	余計	excess, needless
よゆう	余裕	room, leeway
よち	余地	room, space
よぶん	余分	excess, extra
あまる	余る	remain over, be in excess
あまり	余り	remainder, leftover
なんべん	何遍	how many times
なんびゃく	何百	several hundred, hundreds
なんど	何度	how many degrees, how many times
なんぜん	何千	several thousand, thousands
なんじゅう	何十	several tens
なにより	何より	above all, before everything else
なんとなく	何となく	in some way, somehow
なんとか	何とか	somehow or other, one way or another
なんと	何と	what, how
なんで	何で	why, what for
なんて	何て	what, how
なんだか	何だか	somehow, what's what
なにしろ	何しろ	anyhow, as you know
なにか	何か	something, some
なにか	何か	something, some
なに	何	what, which
なん	何	what, which
たいけん	体験	experience
たいじゅう	体重	body weight
たいちょう	体調	health condition
たいいく	体育	physical training, physical education
たいけい	体系	system, organization
たいおんけい	体温計	thermometer
たいおん	体温	body temperature
たいかく	体格	physique, build
たいそう	体操	gymnastics, physical exercise
たいりょく	体力	physical strength
たいせい	体制	system, structure
からだ	体	body, health
じゅうみん	住民	residents, dwellers
じゅうしょ	住所	one's dwelling, address
じゅうたくち	住宅地	residential district
じゅうたく	住宅	housing, residence
すむ	住む	live, reside
すまい	住まい	dwelling, residence
ていおん	低温	low temperature
ていきあつ	低気圧	low pressure, atmospheric depression
ていか	低下	falling, lowering
ひくい	低い	low, short
てい	低	low
いち	位置	position, place
くらい	位	rank, dignity
にあう	似合う	suit, match well
にる	似る	resemble, be alike
にている	似ている	look like, resemble
にせる	似せる	imitate, forge
うかがう	伺う	politely ask
のびる	伸びる	stretch, grow
のばす	伸ばす	stretch, straighten
ともなう	伴う	accompany, go with
でんせつ	伝説	legend, folk tale
でんごん	伝言	verbal message
でんとう	伝統	tradition, convention
でんせん	伝染	contagion, infection
つたわる	伝わる	be transmitted, be handed down
つたえる	伝える	convey, transmit, hand down
かいちょう	会長	president, chairperson
かいひ	会費	fee, membership fee
かいぎ	会議	conference, meeting
かいだん	会談	conversation, meeting
かいわ	会話	conversation
かいけい	会計	account, finance
かいしゃ	会社	company, corporation
かいじょう	会場	venue, meeting place
かいいん	会員	member
あう	会う	meet
かい	会	meeting, association
きゅうよう	休養	rest, recreation
きゅうこう	休講	cancellation of lecture
きゅうぎょう	休業	suspension of business, closure
きゅうこう	休校	temporary closure of school
きゅうか	休暇	holiday, vacation
きゅうじつ	休日	holiday, day off
きゅうけい	休憩	rest, repose
きゅうそく	休息	rest, break
きゅうがく	休学	leave of absence, absence
やすめる	休める	give a rest, set at ease
やすむ	休む	take a day off, take a break
やすみ	休み	rest, holiday, absence
きかく	企画	plan, project
きぎょう	企業	corporation, business
にんむ	任務	duty, mission
まかせる	任せる	entrust to, leave it to
なかま	仲間	comrade, peer
なかよし	仲良し	good friend, chum
なかよく	仲良く	harmoniously, amicably
なかなおり	仲直り	reconciliation, making up
なこうど	仲人	go-between, matchmaker
なか	仲	personal relationship
かてい	仮定	assumption, supposition
かなづかい	仮名遣い	kana orthography, use of kana
かな	仮名	kana, Japanese syllabary
かりに	仮に	supposing that, even if
かり	仮	provisional, temporary
いこう	以降	hereafter
いらい	以来	since
いご	以後	from now on, after that
いぜん	以前	before, ago
いか	以下	below
いじょう	以上	not less than, more than
だいきん	代金	charge, fee
だいひょう	代表	representative
だいめいし	代名詞	pronoun
かわるがわる	代わる代わる	by turns, alternately
かわる	代わる	substitute, be substituted for
かわり	代わり	substitution
かえる	代える	substitute, use in place of
ふろく	付録	appendix, supplement
ふきん	付近	neighborhood, environs
ふぞく	付属	attachment, belonging
つけたす	付け足す	add on, append
つけくわえる	付け加える	add
つける	付ける	attach, set, apply
つく	付く	attach itself to, be connected with, come in contact with
つきあう	付き合う	socialize with, see someone
つきあい	付き合い	friendship, association
たほう	他方	other side
たにん	他人	another person, stranger
た	他	others, other things
ほか	他	other
しまう	仕舞う	put away
しくみ	仕組み	construction, arrangement
しかた	仕方	way, method
しごと	仕事	work, job
しあげる	仕上げる	finish, complete
しあげ	仕上げ	completion, finishing
ぶっきょう	仏教	Buddhism
ほとけ	仏	buddha, Buddhist image
こんしゅう	今週	this week
けさ	今朝	this morning
こんげつ	今月	this month
いまさら	今更	now, too late
こんばん	今晩	this evening, tonight
きょう	今日	today
こんにち	今日	today, these days
こんご	今後	after this, in the future
こんど	今度	this time, next time
ことし	今年	this year
こんや	今夜	tonight, this evening
こんかい	今回	this time
いままで	今まで	until now, so far
いまにも	今にも	at any moment
いまに	今に	before long, someday
いまごろ	今ごろ	about this time
いま	今	now
じんるい	人類	mankind, humankind
にんげん	人間	human being, people
ひとちがい	人違い	mistaken identity
ひとどおり	人通り	traffic
ひとごみ	人込み	crowd
じんしゅ	人種	race
じんせい	人生	human life, life
じんぶつ	人物	character, person
にんき	人気	popularity, temperament of the people, business conditions
じんみん	人民	the people, populace
じんけん	人権	human rights
じんかく	人格	character, personality
ひとがら	人柄	character, personality
じんぶんかがく	人文科学	humanities
にんずう	人数	number of people
ひとで	人手	hand, manpower
にんじょう	人情	human feelings, humanity
にんぎょう	人形	doll
ひとさしゆび	人差し指	index finger
じんこう	人工	artificial
じんめい	人名	personal name, name
じんこう	人口	population
ひとまえ	人前	in front of other people
ひとで	人出	turnout, crowd
じんじ	人事	human affairs, personnel affairs
ひとびと	人々	people
ひと	人	person
こうさい	交際	association, friendship
こうつうひ	交通費	traveling expense, transportation cost
こうつうじこ	交通事故	traffic accident
こうつう	交通	traffic, transportation
こうばん	交番	police box
こうしょう	交渉	negotiation, bargaining
こうりゅう	交流	interaction, contact
こうたい	交替	alternation, shift
こうかん	交換	exchange, bartering
こうさてん	交差点	crossing, intersection
こうご	交互	by turns, alternatively
まじわる	交わる	cross
まじわる	交わる	associate with, socialize
かわす	交わす	exchange
まぜる	交ぜる	include
まじる	交じる	be mingled, be mixed
まざる	交ざる	mix, socialize with
なくなる	亡くなる	die, pass away
なくす	亡くす	lose (in death)
いつか	五日	five days, 5th of the month
ごじゅうおん	五十音	Japanese syllabary
いつつ	五つ	five (things)
ご	五	five
たがい	互い	each other
にかい	二階	second floor, upstairs
にりゅう	二流	second-rate
ふつか	二日	two days, 2nd of the month
にどと	二度と	never again
はたち	二十歳	20 years old
はつか	二十日	20 days, 20th of the month
ふたり	二人	two persons
ふたつ	二つ	two (things)
に	二	two
じぎょう	事業	business, achievement
ことがら	事柄	matter, affair
じこ	事故	accident, incident
じたい	事態	situation, state of affairs
じじょう	事情	circumstances, conditions
じじつ	事実	fact, truth
じむしょ	事務所	office, one's place of business
じむしつ	事務室	office
じむいん	事務員	clerk, clerical staff
じむ	事務	office duty, clerical work
じけん	事件	affair, case
こと	事	thing, incident
あらそう	争う	compete, fight
あらそい	争い	conflict, battle
よぼう	予防	prevention, protection
よげん	予言	prediction, forecast
よしゅう	予習	preparation, previewing (a lesson)
よやく	予約	reservation, subscription
よさん	予算	budget
よそう	予想	prospect, expectation
よてい	予定	schedule, plan
よほう	予報	forecast, prediction
よび	予備	reserve, spare
かめ	亀	turtle, tortoise
かんそう	乾燥	drying up, desiccation
かんぱい	乾杯	a toast
かわく	乾く	dry, run dry
かわかす	乾かす	dry
らんぼう	乱暴	violence
みだれる	乱れる	be disordered, be disturbed
みだす	乱す	put into disorder, disrupt
こじき	乞食	beggar
ここのか	九日	nine days, 9th of the month
ここのつ	九つ	nine (things)
きゅう	九	nine
く	九	nine
じょうしゃけん	乗車券	railway ticket, bus ticket
じょうしゃ	乗車	boarding, getting on board
じょうきゃく	乗客	passenger
のる	乗る	ride, take
のりおり	乗り降り	getting on and off
のりおくれる	乗り遅れる	miss
のりこむ	乗り込む	board, march into
のりこす	乗り越す	ride past
のりこし	乗り越し	riding past one's stop
のりこえる	乗り越える	overcome, get over
のりもの	乗り物	vehicle, conveyance
のりかえる	乗り換える	change, transfer
のりかえ	乗り換え	change, transfer
のりだす	乗り出す	lean forward, embark on
とぼしい	乏しい	scarce, short of
ひさしぶり	久しぶり	after a long time
どんぶり	丼	bowl
しゅしょく	主食	staple food
しゅだい	主題	subject, theme
しゅかんてき	主観的	subjective
しゅかん	主観	subjectivity, subject
しゅよう	主要	main, principal
しゅぎ	主義	principle, -ism
しゅやく	主役	leading part, starring role
しゅちょう	主張	insistence, assertion
しゅふ	主婦	housewife
しゅさい	主催	sponsorship, promotion
しゅたい	主体	agent, main constituent
しゅにん	主任	person in charge, head
しゅじん	主人	master, husband
おもに	主に	mainly, mostly
おも	主	main, chief
まるい	丸い	round
まる	丸	circle or sphere, wholeness
ちゅうかん	中間	middle, between
ちゅうと	中途	halfway
なかみ	中身	content, interior
ちゅうけい	中継	relay, broadcasting
ちゅうきゅう	中級	middle-class, intermediate
ちゅうりつ	中立	neutrality
ちゅうりゅう	中流	mid-stream, middle reaches
ちゅうどく	中毒	poisoning
ちゅうし	中止	suspension, stopping
ちゅうじゅん	中旬	middle ten days of a month
ちゅうだん	中断	interruption, discontinuance
なかゆび	中指	middle finger
ちゅうしん	中心	center, middle
ちゅうねん	中年	middle age
ちゅうがくせい	中学生	junior high school student
ちゅうがっこう	中学校	junior high school
ちゅうがく	中学	junior high school
ちゅうおう	中央	center
ちゅうこ	中古	secondhand goods
ちゅうせい	中世	Middle Ages
なか	中	inside, middle
ちゅう	中	middle, medium size
なみき	並木	row of trees, roadside trees
なみ	並み	ordinary, average
ならべる	並べる	line up, display, set up
ならぶ	並ぶ	line up, be parallel
りょうめん	両面	both sides
りょうしん	両親	parents
りょうしゃ	両者	both
りょうりつ	両立	managing two things, having it both ways
りょうがえ	両替	money changing, exchange of money
りょうほう	両方	both
りょうて	両手	both hands
りょうがわ	両側	both sides
おか	丘	hill, slope
せけん	世間	world, the public
せろん	世論	public opinion
よろん	世論	public opinion
せわ	世話	take care of, provide service
せいき	世紀	century
せかい	世界	world
せだい	世代	generation
よのなか	世の中	the world, society
よ	世	world, public,
あたえる	与える	give
ふうん	不運	misfortune, bad luck
ふつう	不通	interruption of service
ふそく	不足	insufficiency, lack
ふしんせつ	不親切	unkind, inattentive
ふきそく	不規則	irregular
ふよう	不要	unnecessary, waste
ふりょう	不良	bad, defective
ふじゆう	不自由	inconvenience, discomfort
ふしぜん	不自然	unnatural, artificial
ふたしか	不確か	unreliable, uncertain
ふけつ	不潔	dirty, filthy
ふまん	不満	dissatisfaction, discontent
ふちゅうい	不注意	carelessness, inattention
ふきょう	不況	depression, slump
ふせい	不正	fraud, impropriety
ふきげん	不機嫌	bad mood, displeasure
ふけいき	不景気	business depression, slump
ふめい	不明	unknown
ふゆかい	不愉快	unpleasant, disagreeable
ふしぎ	不思議	mystery, wonder
ふひつよう	不必要	unnecessary, superfluous
ふとくい	不得意	one's weak point
ふしあわせ	不幸せ	unhappiness, misfortune
ふこう	不幸	unhappiness, misfortune, bereavement
ふびょうどう	不平等	unequal, unfair
ふへい	不平	discontent, dissatisfaction
ふかんぜん	不完全	imperfection, incompleteness
ふあんてい	不安定	instability
ふあん	不安	uneasiness, anxiety
ふざい	不在	absence
ぶきよう	不器用	clumsy, unskillful
ふごうかく	不合格	failure, disqualification
ふかのう	不可能	impossible
ふじゅうぶん	不十分	insufficiency, lack
ふどうさんや	不動産屋	real estate agent, realtor
ふり	不利	disadvantage
ふこうへい	不公平	unfair, unjust
ふべん	不便	inconvenient
げしゃ	下車	get off, stopover
したしらべ	下調べ	preliminary investigation, preparation
したぎ	下着	underwear
げり	下痢	diarrhea
したまち	下町	old part of town
かりゅう	下流	downstream
げすい	下水	sewerage, drainage
したがき	下書き	draft
げじゅん	下旬	end of the month
へた	下手	not good at
げしゅく	下宿	lodging, boarding house
げひん	下品	vulgar, low
おろす	下ろす	bring down, take down, pull down
くだる	下る	go down, go down or away from a central place
おりる	下りる	go down, come down
くだり	下り	downhill, going down
くださる	下さる	give, favor with
さげる	下げる	lower, turn down
さがる	下がる	come down, hang down, fall
した	下	under, below
げ	下	low class, inferiority, below
もと	下	under the supervision
じょうたつ	上達	progress, proficiency
じょうきゅう	上級	higher grade, advanced class
じょうとう	上等	first-class, premium
うわぎ	上着	coat, jacket
じょうりゅう	上流	upstream
じょうしょう	上昇	ascension, rising
じょうじゅん	上旬	beginning of the month
じょうず	上手	good, skilled
じょうひん	上品	elegance, refinement
じょうし	上司	boss
じょうげ	上下	top and bottom
うえした	上下	above and below
のぼる	上る	go up
のぼり	上り	going up, ascent
あげる	上げる	raise, improve
あがる	上がる	go up, rise
あがる	上がる	get nervous, get stage fright
あがる	上がる	be completed
あがる	上がる	eat, drink
うえ	上	up, above
かみ	上	superiors, people in authority
じょう	上	upper, best
さんかくけい	三角形	triangle
さんかく	三角	triangle
さんりゅう	三流	third-rate
みかづき	三日月	new moon, crescent moon
みっか	三日	three days, 3rd of the month
みっつ	三つ	three (things)
さん	三	three
じょうぶ	丈夫	healthy, stout
ばんざい	万歳	Banzai! Hurrah! Long live...!
まんねんひつ	万年筆	fountain pen
まんいち	万一	if by any chance
まん	万	ten thousand
なのか	七日	seven days, 7th of the month
たなばた	七夕	Tanabata Festival, Star Festival
ななつ	七つ	seven (things)
しち	七	seven
なな	七	seven
ていねい	丁寧	polite, courteous, careful
いちめん	一面	whole surface
いちぶぶん	一部分	part, portion
いちぶ	一部	part
いっぺんに	一遍に	all at once
ひととおり	一通り	briefly, once over
ひとこと	一言	single word
いっけん	一見	at a glance
いっぱんに	一般に	generally, in general
いっぱん	一般	general, common
いっち	一致	accord, agreement
いっしょに	一緒に	together, at the same time
いっしょ	一緒	together
いっしゅ	一種	a kind of, a sort of
いっしゅ	一種	a kind of, of sorts
いっしゅん	一瞬	instant, moment
いちばん	一番	most
いっしょうけんめい	一生懸命	for life, with all one's might
いっしょう	一生	a lifetime
いちりゅう	一流	top-ranked, world-class
いちだんと	一段と	greater, further
いっぱい	一杯	full
いちじ	一時	temporarily
いっさくじつ	一昨日	the day before yesterday
おととい	一昨日	day before yesterday
いっさくねん	一昨年	the year before last
おととし	一昨年	the year before last
いったん	一旦	once, for a while
ついたち	一日	1st of the month
いっぽう	一方	one way
いっせいに	一斉に	all together, all at once
いちおう	一応	tentatively
いちどに	一度に	at a time, at once
いったい	一帯	area, vicinity
いっそう	一層	more, even more
いっか	一家	household, family
いってい	一定	constant, standard
いちいん	一員	member
いっしゅう	一周	circle, around
いっこうに	一向に	absolutely, at all
いちどう	一同	everybody, all
ひとくち	一口	mouthful, bite
いっさい	一切	not at all, not one bit
いったい	一体	what on earth, what the…
ひとやすみ	一休み	rest
ひとりひとり	一人一人	each and every person
ひとりで	一人で	by oneself
ひとり	一人	one, one person
ひとまず	一まず	first of all
ひとつ	一つ	one (thing)
いち	一	one
ワンピース	ワンピース	dress
わずか	わずか	few, little
わざわざ	わざわざ	go to a lot of trouble
わさび	わさび	wasabi, Japanese horseradish
わざと	わざと	on purpose
わくわく	わくわく	feel excited
わく	わく	well up
わがまま	わがまま	selfishness, willfulness
ワイン	ワイン	wine
ワイシャツ	ワイシャツ	(business) shirt, (white) shirt
ワープロ	ワープロ	word processor
ロマンチック	ロマンチック	romantic
ロボット	ロボット	robot
ロック	ロック	rock (music)
ロッカー	ロッカー	locker
ろくに	ろくに	hardly, barely
ろうそく	ろうそく	candle
ろーまじ	ローマ字	Roman alphabet
ロープ	ロープ	rope
レントゲン	レントゲン	X-rays
レンズ	レンズ	lens
レモン	レモン	lemon
レポート	レポート	report, paper
レベル	レベル	level
レストラン	レストラン	restaurant
レシート	レシート	receipt
レコード	レコード	record
レクリエーション	レクリエーション	recreation, games
レインコート	レインコート	raincoat
ルール	ルール	rule
りんご	りんご	apple
リボン	リボン	ribbon
リットル	リットル	liter, litre
リズム	リズム	rhythm
リクエスト	リクエスト	request
リード	リード	the lead, take a lead
ランチ	ランチ	lunch
ラッシュアワー	ラッシュアワー	rush hour
ラッシュ	ラッシュ	rush, rush hour
ラジオ	ラジオ	radio
ラケット	ラケット	racket
ラグビー	ラグビー	rugby
ライター	ライター	lighter
ラーメン	ラーメン	ramen (Chinese noodles)
よろしく	よろしく	properly, one's regards
よろしい	よろしい	all right
よる	よる	be caused by
より	より	more, further
よほど	よほど	very, by far
ヨット	ヨット	sailboat, yacht
よそみ	よそ見	look around
よそ	よそ	somewhere else
よす	よす	quit, stop
よこす	よこす	send, hand over
よける	よける	avoid, evade
よける	よける	move out the way
よく	よく	often
よく	よく	well
ようやく	ようやく	at last, at length
ようこそ	ようこそ	welcome
よう	よう	way, like, kind
ゆとり	ゆとり	room, leeway
ゆでる	ゆでる	boil
ゆったり	ゆったり	comfortable
ゆっくり	ゆっくり	slowly
ユーモア	ユーモア	humor
やる	やる	do
やる	やる	give (to an inferior)
やりなおす	やり直す	do over again
やりなおし	やり直し	doing over, redoing
やりかた	やり方	way of doing
やや	やや	little, somewhat
やはり	やはり	as expected, also, still
やっぱり	やっぱり	just as I thought, after all
やっと	やっと	at last, finally
やってくる	やって来る	come, turn up
やっつける	やっつける	beat, let someone have it
やたらに	やたらに	frequently, persistently
やけど	やけど	burn
やかん	やかん	kettle
やかましい	やかましい	noisy, clamorous
やがて	やがて	soon, before long
もろい	もろい	weak, brittle
もらう	もらう	receive
もむ	もむ	rub, massage
もはや	もはや	already, no longer
モデル	モデル	model
もてる	もてる	be popular with the opposite sex
もっとも	もっとも	quite right
もっと	もっと	more
もったいない	もったいない	wasteful, a shame
もちろん	もちろん	of course, no doubt
モダン	モダン	modern
もたらす	もたらす	bring about, lead to
もしも	もしも	if, if ever
もしかすると	もしかすると	possibly, perhaps
もしかしたら	もしかしたら	possibly, perhaps
もし	もし	if, in case of
もうじき	もうじき	soon
もうける	もうける	make a profit
もうけ	もうけ	profits, earnings
もうかる	もうかる	make a profit, be profitable
もう	もう	already, yet
もう	もう	another, again
モーター	モーター	motor, engine
メンバー	メンバー	member
メロディー	メロディー	melody
メモ	メモ	memorandum, memo pad
メニュー	メニュー	menu, bill of fare
めでたい	めでたい	happy, fortunate
めったに	めったに	rarely
めくる	めくる	turn over
めいめい	めいめい	each, individual
メーター	メーター	meter, taximeter
メーカー	メーカー	maker, manufacturer
むなしい	むなしい	empty, vain
むしろ	むしろ	rather
むける	むける	come off, peel
むく	むく	peel, pare
ムード	ムード	mood
みんな	みんな	all, everybody
ミルク	ミルク	milk, baby milk
ミュージック	ミュージック	music
ミスプリント	ミスプリント	misprint, error
ミス	ミス	mistake
みかん	みかん	tangerine, mandarin orange
ミーティング	ミーティング	meeting
マンション	マンション	apartment, apartment block, condominium
まれ	まれ	rarely
まるで	まるで	just like, completely
マラソン	マラソン	marathon
マヨネーズ	マヨネーズ	mayonnaise
ママ	ママ	mommy, mummy
まま	まま	as is, still (in the current state)
マフラー	マフラー	scarf, muffler
まぶた	まぶた	eyelid
まぶしい	まぶしい	dazzling, glaring
まねる	まねる	imitate, mimic
マネー	マネー	money, finance
まね	まね	imitation, mimicry
まないた	まな板	chopping board
マナー	マナー	manners
まとめる	まとめる	gather together, put in order
まとめ	まとめ	summary
まとまる	まとまる	be collected
マッチ	マッチ	match, matchbox
ますます	ますます	increasingly
マスコミ	マスコミ	mass communication
まずい	まずい	bad-tasting, bad
まずい	まずい	bad, no good
まずい	まずい	problematic, troublesome
まして	まして	much more
まし	まし	more, better
まさか	まさか	never in a million years
まぐろ	まぐろ	tuna
まく	まく	scatter, plant
まく	まく	sow, scatter
マイナス	マイナス	minus, below zero
マイク	マイク	mic, microphone
まあまあ	まあまあ	OK, not bad, average
まあまあ	まあまあ	now now
まあ	まあ	well
マーケット	マーケット	market
マーク	マーク	logo
ぼんやり	ぼんやり	vaguely, absent-mindedly
ボリューム	ボリューム	volume
ほほえむ	ほほえむ	smile
ほぼ	ほぼ	almost, nearly
ほほ	ほほ	cheek
ほとんど	ほとんど	almost, hardly
ほどく	ほどく	undo, unfasten
ホテル	ホテル	hotel
ポット	ポット	pot, thermos
ほっと	ほっと	feel relieved
ホット	ホット	hot
ボタン	ボタン	button
ポスト	ポスト	post box, letter box
ポスター	ポスター	poster
ほこり	ほこり	dust
ポケット	ポケット	pocket
ぽかぽか	ぽかぽか	pleasantly warm
ほうれんそう	ほうれん草	spinach
ほうき	ほうき	broom
ボールペン	ボールペン	ballpoint pen
ボール	ボール	ball
ホーム	ホーム	platform
ボーナス	ボーナス	bonus
ボート	ボート	boat
ボーイフレンド	ボーイフレンド	boyfriend
ボーイ	ボーイ	waiter
ペンチ	ペンチ	pliers
ベンチ	ベンチ	bench
ペンキ	ペンキ	paint
ペン	ペン	pen
ベルト	ベルト	belt
ベル	ベル	bell
ヘリコプター	ヘリコプター	helicopter
ぺらぺら	ぺらぺら	fluently
ぺらぺら	ぺらぺら	floppy, flimsy
ベテラン	ベテラン	veteran
ベッド	ベッド	bed
べたべた	べたべた	stick together
へそ	へそ	the navel, the bellybutton
ベスト	ベスト	best
ぺこぺこ	ぺこぺこ	hungry, starving
ぺこぺこ	ぺこぺこ	bow, kowtow
ペース	ペース	pace
ページ	ページ	page
ふわふわ	ふわふわ	soft
プロやきゅう	プロ野球	professional baseball
プログラム	プログラム	program
プロ	プロ	pro, professional
プレゼント	プレゼント	present, gift
ブレーキ	ブレーキ	brake
ぶるぶる	ぶるぶる	shiver
フルーツ	フルーツ	fruit
プリント	プリント	print
ぶらさげる	ぶら下げる	hang, suspend
ぶらさがる	ぶら下がる	hang down, dangle
プラン	プラン	plan
ぶらぶら	ぶらぶら	wander aimlessly, hang about
ふらふら	ふらふら	weak
プラットホーム	プラットホーム	platform
プラスチック	プラスチック	plastic
プラス	プラス	plus, advantage
ブラシ	ブラシ	brush
ブラウス	ブラウス	blouse
フライパン	フライパン	frying pan
プライド	プライド	pride
ふもと	ふもと	foot of the mountain
ぶどう	ぶどう	grapes
ふと	ふと	suddenly, unexpectedly
ぶつぶつ	ぶつぶつ	grumble
ぶつける	ぶつける	bump
ぶつかる	ぶつかる	hit, bump into
ふた	ふた	lid, cover
ふすま	ふすま	sliding door, fusuma
ふざける	ふざける	mess around, fool around
フォーク	フォーク	fork
フィルム	フィルム	film
ファン	ファン	fan, lover
ファッション	ファッション	fashion
ファックス	ファックス	facsimile, fax
プール	プール	pool
ブーム	ブーム	boom
ピンポン	ピンポン	table tennis, ping pong
ヒント	ヒント	hint, clue
ピンク	ピンク	pink
ピン	ピン	hairpin, pin
ビル	ビル	building
ひらりと	ひらりと	lightly, delicately
ひらひら	ひらひら	lightly, floating
ぴょんぴょん	ぴょんぴょん	jump, hop
ぴょんと	ぴょんと	jump
ひょっとしたら	ひょっとしたら	perhaps
ひも	ひも	laces, string, rope
ひび	ひび	crack
ひねる	ひねる	twist, turn
ビニール	ビニール	plastic bag
ひとりでに	ひとりでに	automatically, by oneself
ひどい	ひどい	cruel, severe
ビデオテープ	ビデオテープ	videotape
ビデオ	ビデオ	video
ぴったり	ぴったり	exactly right, perfect
びっしょり	びっしょり	soaked
びっくりする	びっくりする	surprised
ぴたりと	ぴたりと	suddenly
ビタミン	ビタミン	vitamin
ピストル	ピストル	pistol
びしょびしょ	びしょびしょ	soaked
ビジネス	ビジネス	business
ひじ	ひじ	elbow
ビザ	ビザ	visa
ひざ	ひざ	knee
ひげ	ひげ	moustache, beard
ピクニック	ピクニック	picnic
ひく	ひく	run over
ぴかぴか	ぴかぴか	new, shiny
ピアノ	ピアノ	piano
ビール	ビール	beer, lager
ビーチ	ビーチ	beach
ハンバーガー	ハンバーガー	hamburger
ハンドル	ハンドル	steering wheel
ハンドバッグ	ハンドバッグ	handbag
パンティー	パンティー	panties
パンツ	パンツ	pants, trousers
ぱんだ	ぱんだ	panda
パンク	パンク	puncture
ハンカチ	ハンカチ	handkerchief
パン	パン	bread
はれる	はれる	swell, swell up
バレーボール	バレーボール	volleyball
ばらいろ	ばら色	rose color
バランス	バランス	balance
ばらばら	ばらばら	separately
ばら	ばら	rose
はめる	はめる	put on, wear
ハム	ハム	ham
パパ	パパ	dad, father
はねる	はねる	run over, hit
バナナ	バナナ	banana
パトカー	パトカー	police car, patrol car
ぱっと	ぱっと	suddenly, quickly
バット	バット	bat
はっと	はっと	taken aback
バッジ	バッジ	badge
バッグ	バッグ	bag
バック	バック	back
はっきり	はっきり	clearly
バツ	バツ	cross, x-mark
パチンコ	パチンコ	pachinko (vertical pinball)
はだし	はだし	barefoot, bare feet
パターン	パターン	pattern
バター	バター	butter
パソコン	パソコン	personal computer
ばすてい	バス停	bus stop
パスポート	パスポート	passport
バスケットボール	バスケットボール	basketball
バス	バス	bus
パジャマ	パジャマ	pajamas
はしご	はしご	ladder
はげる	はげる	come off, peel off
バケツ	バケツ	bucket
はかり	はかり	scales
ばからしい	ばからしい	stupid, useless
ばかばかしい	ばかばかしい	stupid, absurd
はえ	はえ	fly
ばいきん	ばい菌	bacterium, germ
パイロット	パイロット	pilot
パイプ	パイプ	pipe
ぱいなっぷる	ぱいなっぷる	pineapple
バイト	バイト	part-time job
バイク	バイク	motorbike, motor cycle
ハイキング	ハイキング	hiking
バイオリン	バイオリン	violin
ハードウェア	ハードウェア	hardware
ハード	ハード	hard
パーティー	パーティー	party
パーセント	パーセント	percent
バーゲン	バーゲン	bargain sale
のんびり	のんびり	take it easy
のんき	のんき	carefree, easy-going
のろのろ	のろのろ	slowly, easy
のろい	のろい	slow, sluggish
のどか	のどか	tranquil, peaceful
ノック	ノック	knock
のぞく	のぞく	look, peep
ノーベルしょう	ノーベル賞	Nobel Prize
ノート	ノート	note book, laptop
ネットワーク	ネットワーク	network
ネックレス	ネックレス	necklace
ねずみ	ねずみ	rat, mouse
ネクタイ	ネクタイ	tie, necktie
ねぎ	ねぎ	Welsh onion, green onion
ぬるぬる	ぬるぬる	slimy
ぬるい	ぬるい	tepid, lukewarm
にんじん	にんじん	carrot
にわかに	にわかに	rapidly
にらむ	にらむ	glare, stare
ニュース	ニュース	news
にやにや	にやにや	grin to oneself
にっこり	にっこり	smiling, grinning
にこやか	にこやか	smiling, beaming
にこにこ	にこにこ	smile
ナンバー	ナンバー	number
なるほど	なるほど	I see, really
なるべく	なるべく	as...as possible, if possible
なる	なる	become
なる	なる	become
なめる	なめる	lick, lap
なぜか	なぜか	for some reason
なぜ	なぜ	why, for what reason
なさる	なさる	do
なかなか	なかなか	not at all, hardly
なかなか	なかなか	rather, pretty
なお	なお	still, in addition
ナイロン	ナイロン	nylon
ナイフ	ナイフ	knife
トンネル	トンネル	tunnel
どんなに	どんなに	how much
どんどん	どんどん	knock
どんどん	どんどん	steadily
とんとん	とんとん	tapping
とんでもない	とんでもない	unthinkable, outrageous
とんかつ	とんかつ	pork cutlet
ドレス	ドレス	dress
トレーニング	トレーニング	training, workout
どれ	どれ	what, which
ドル	ドル	dollar
トランプ	トランプ	(a pack of) cards, (playing) cards
ドラマ	ドラマ	drama, theater, soap opera
トラック	トラック	truck, lorry
ドライブ	ドライブ	drive
ともかく	ともかく	at least, at any rate
トマト	トマト	tomato
とにかく	とにかく	in any case, anyway
どなた	どなた	who
とても	とても	very
トップ	トップ	top
どっと	どっと	burst (out laughing)
どっち	どっち	which
とっさに	とっさに	at once
とっくに	とっくに	long ago
どちら	どちら	which
とじる	とじる	bind, file
ところ	ところ	place
どこ	どこ	where
どく	どく	move out of the way
どきどき	どきどき	feel excited, feel nervous
どきっと	どきっと	surprised, shocked
とがる	とがる	be sharp
どうやら	どうやら	seems, looks like
とうもろこし	とうもろこし	corn, maize
どうも	どうも	for some reason, somehow
どうにか	どうにか	somehow
とうとう	とうとう	at last, after all
どうぞ	どうぞ	please
どうせ	どうせ	anyway
どうしても	どうしても	by any means, really
どうして	どうして	why
どうか	どうか	please
どう	どう	how, what
トイレットペーパー	トイレットペーパー	toilet paper
トイレ	トイレ	toilet
ドア	ドア	door
トースト	トースト	toast
テンポ	テンポ	tempo, pace
てんぷら	てんぷら	tempura, Japanese deep-fried breaded food
テント	テント	tent
テレビ	テレビ	television
デモ	デモ	demonstration
デパート	デパート	department store, department
てのひら	てのひら	palm
テニス	テニス	tennis
テスト	テスト	test, exam
デザイン	デザイン	design
デザート	デザート	dessert
でこぼこ	でこぼこ	unevenness, bumpiness
テキスト	テキスト	textbook, text, text file
ティッシュ	ティッシュ	tissue
ディスコ	ディスコ	disco
テーマ	テーマ	the theme, the subject
テープレコーダー	テープレコーダー	tape recorder, cassette recorder
テーブル	テーブル	table
テープ	テープ	tape, cassette
デート	デート	date
データ	データ	data
つるつる	つるつる	smooth, slippery
ツル	ツル	crane, stork
つもり	つもり	intention, purpose
つまり	つまり	in short, basically
つまらない	つまらない	boring, dull
つまむ	つまむ	munch on
つまずく	つまずく	stumble, trip
つぼみ	つぼみ	bud
つぶる	つぶる	close
つぶやく	つぶやく	mutter, murmur
つばめ	つばめ	swallow
つなぐ	つなぐ	connect, join
つながる	つながる	connect, join
つながり	つながり	connection, relation
つける	つける	switch on
つくづく	つくづく	truly, deeply
つぐ	つぐ	pour, pour into
つく	つく	be on, switched on
つかむ	つかむ	grip, grab
つかまる	つかまる	grip, grab
ついに	ついに	at last, finally
ついで	ついで	on the way
つい	つい	inadvertently, accidentally
ちり	ちり	dust
ちょっと	ちょっと	just a moment, just a little, easily
チョコレート	チョコレート	chocolate
ちょうど	ちょうど	just, as if
チョーク	チョーク	chalk
チャンネル	チャンネル	channel
ちゃんと	ちゃんと	regularly, properly
チャンス	チャンス	chance
ちっとも	ちっとも	nothing at all
チケット	チケット	ticket
チキン	チキン	chicken, fried chicken
ちぎれる	ちぎれる	be torn off, come off
ちぎる	ちぎる	tear, tear off
チェンジ	チェンジ	change, exchange
チーム	チーム	team
チーズ	チーズ	cheese
ダンス	ダンス	dance, dancing
たんす	たんす	chest of drawers, wardrobe
タレント	タレント	celebrity, talent
だるい	だるい	be dull, feel dull, weary
だらしない	だらしない	slovenly, untidy
ため	ため	sake, purpose
ダム	ダム	dam
たまらない	たまらない	can't stand, can't put up with
たまに	たまに	occasionally, by chance
たまたま	たまたま	by chance, accidentally
だぶだぶ	だぶだぶ	baggy, too big
たばこや	たばこ屋	cigarette shop, tobacco store
たばこ	たばこ	tobacco, cigarette
たとえ	たとえ	even if, granting that
たっぷり	たっぷり	fully, amply
たった	たった	only, merely
たちまち	たちまち	in a moment, instantly
ただ	ただ	free
ただ	ただ	simply, merely
たこ	たこ	octopus
タクシー	タクシー	taxi, cab
たくさん	たくさん	in large quantity, plenty
タオル	タオル	towel
ダウン	ダウン	down, malfunction
ダイヤモンド	ダイヤモンド	diamond
タイヤ	タイヤ	tire
タイプライター	タイプライター	typewriter
タイプ	タイプ	type
そんなに	そんなに	that, so
ぞんざい	ぞんざい	rough, rude
そろそろ	そろそろ	soon, quietly
それほど	それほど	so much, that much
それぞれ	それぞれ	each, respective
それ	それ	that, that one
ソフト	ソフト	software, programme
ソファー	ソファー	sofa, sofa bed
そびえる	そびえる	tower
そばや	そば屋	soba restaurant
そば	そば	side, vicinity
そば	そば	buckwheat noodles, soba
そのうち	その内	before long, sooner or later
そのまま	そのまま	like that, unchanged
そっと	そっと	softly, gently
そっち	そっち	there, thou
そっくり	そっくり	identical, look alike
そちら	そちら	there, that way
そこ	そこ	there
そう	そう	in such manner, that way
ソース	ソース	sauce, Worcestershire sauce
センター	センター	center
セロテープ	セロテープ	cellophane tape, Scotch tape, Sellotape
ゼロ	ゼロ	zero
セルフサービス	セルフサービス	self-service
せめて	せめて	at least
セット	セット	set
せっせと	せっせと	hard, diligently
せっかち	せっかち	impatient
せっかく	せっかく	with much trouble, specially
ぜいたく	ぜいたく	luxury, extravagance
せいぜい	せいぜい	at most
せい	せい	cause, fault
セールスマン	セールスマン	sales representative, salesperson
セーター	セーター	sweater, pullover
ずれる	ずれる	off track, out of line
ずるがしこい	ずるがしこい	sly, cunning
ずるい	ずるい	cunning, sneaky
する	する	do, make
スリッパ	スリッパ	slippers
すり	すり	pickpocket
ずらり	ずらり	line up neatly
すらすら	すらすら	unhesitantly, confidently
スライド	スライド	slide
すやすや	すやすや	peaceful and content
スモッグ	スモッグ	smog
スマート	スマート	sophisticated, skillful
ズボン	ズボン	trousers, pants
スポーツ	スポーツ	sport
すべすべ	すべすべ	smooth
スプーン	スプーン	spoon
スピード	スピード	speed
スピーチ	スピーチ	speech
スピーカー	スピーカー	speaker
ストレス	ストレス	stress
ストライキ	ストライキ	strike
ストップ	ストップ	stop
ストーブ	ストーブ	paraffin heater, stove
ステレオ	ステレオ	stereo
ステージ	ステージ	stage
ずっと	ずっと	all day, from start to finish
すっと	すっと	clear
すっきり	すっきり	refreshed
すっかり	すっかり	all, completely
スチュワーデス	スチュワーデス	flight attendant
スタンド	スタンド	table lamp, desk lamp
スタイル	スタイル	style
スタート	スタート	start, begin
スター	スター	star
スケジュール	スケジュール	schedule
スケート	スケート	skate, skates
すきやき	すき焼き	sukiyaki
スキー	スキー	ski, skiing
スカート	スカート	skirt
ずうずうしい	ずうずうしい	cheeky, impudent
スイッチ	スイッチ	switch
すいか	すいか	watermelon
スープ	スープ	soup, broth
スーパーマーケット	スーパーマーケット	supermarket
スーツ	スーツ	suit
しわ	しわ	wrinkle
じろじろ	じろじろ	stare
シリーズ	シリーズ	series
ショッピング	ショッピング	shopping
しょっちゅう	しょっちゅう	frequently, repeatedly
ショック	ショック	shock, surprise
ジョギング	ジョギング	jogging
ジュース	ジュース	juice, soft drink
シューズ	シューズ	shoes, sports shoes
ジャンプ	ジャンプ	jump
じゃんじゃん	じゃんじゃん	many times, repeatedly
シャワー	シャワー	shower
ジャム	ジャム	jam
しゃべる	しゃべる	chat, talk
じゃぶじゃぶ	じゃぶじゃぶ	vigorously
シャッター	シャッター	shutter
シャツ	シャツ	shirt
ジャズ	ジャズ	jazz
しゃがむ	しゃがむ	squat down
ジャガイモ	ジャガイモ	potato
シャープペンシル	シャープペンシル	mechanical pencil
ジャーナリズム	ジャーナリズム	journalism
ジャーナリスト	ジャーナリスト	journalist
じめじめ	じめじめ	feel damp, clammy
しびれる	しびれる	become numb, get pins and needles
しばらく	しばらく	awhile, long time, for the time being
しばしば	しばしば	often, frequently
じっと	じっと	without moving, still
しつこい	しつこい	persistent
しっかり	しっかり	mature, reliable
システム	システム	system
ジェットき	ジェット機	jet airplane
ジーパン	ジーパン	jeans
シーツ	シーツ	sheet
シーズン	シーズン	season
サンドイッチ	サンドイッチ	sandwich
サングラス	サングラス	sunglasses
サラリーマン	サラリーマン	office worker, salaried worker, company employee
サラダ	サラダ	salad
ざらざら	ざらざら	rough, gritty
サボる	サボる	blow off, play truant
さっぱり	さっぱり	completely, not at all
さっと	さっと	quickly, suddenly
さっき	さっき	some time ago, only a moment ago
サッカー	サッカー	soccer, football
さぞ	さぞ	no doubt, must
さす	さす	pour
サイン	サイン	signature, autograph
ざあざあ	ざあざあ	heavily, pouring
サービス	サービス	service, on the house
サークル	サークル	circle, club
ごはん	ご飯	cooked rice, meal
ごぞんじ	ご存じ	know
ごめん	ご免	sorry
ごしゅじん	ご主人	(your) husband
コンピューター	コンピューター	computer
こんなに	こんなに	this, so, such
コンテスト	コンテスト	contest
コンセント	コンセント	outlet, wall socket
コンサート	コンサート	concert
コンクリート	コンクリート	concrete
コンクール	コンクール	contest, competition
ごろごろ	ごろごろ	rumble
これら	これら	these
これまで	これまで	until now, until here
これから	これから	from now on, after this
これ	これ	this, this one
ゴルフ	ゴルフ	golf
ゴム	ゴム	elastic
ごみ	ごみ	rubbish, trash
ごまかす	ごまかす	deceive, evade
コマーシャル	コマーシャル	commercial, advertising
こぼれる	こぼれる	spill, overflow
こぼす	こぼす	spill
コピー	コピー	copy, photocopy
このごろ	この頃	now, these days, recently
このあいだ	この間	the other day, recently
このたび	この度	on this occasion
ことわざ	ことわざ	proverb, common saying
コップ	コップ	cup, glass
こっち	こっち	here
こっそり	こっそり	stealthily, secretly
コック	コック	cook, chef
こちら	こちら	here, this way
ごちそうする	ごちそうする	treat
ごちそう	ごちそう	feast, treat
こたつ	こたつ	kotatsu, heated table with a coverlet
こしょう	こしょう	pepper
ここ	ここ	here
ごくんと	ごくんと	in one gulp
こう	こう	like this, this kind of
ゴールデンウィーク	ゴールデンウィーク	golden week
コーラ	コーラ	cola, coke
コーヒー	コーヒー	coffee
コーナー	コーナー	corner
コード	コード	cord
コート	コート	court
コート	コート	coat, jacket
コーチ	コーチ	coach
コース	コース	course, route
げらげら	げらげら	out loud
けち	けち	stingy, miser
ゲーム	ゲーム	game
ケース	ケース	case
ケーキ	ケーキ	cake
くれる	くれる	be given
ぐるぐる	ぐるぐる	round and round
くるくる	くるくる	round and round, spin
グループ	グループ	group
クリスマス	クリスマス	Christmas
グリーン	グリーン	green
クリーム	クリーム	cream
クリーニング	クリーニング	cleaning, laundry
グラム	グラム	gram
グラフ	グラフ	chart, graph
クラブ	クラブ	club
グラス	グラス	glass
クラス	クラス	class
クラス	クラス	class, lesson
クラシック	クラシック	classical music, the classics
ぐらぐら	ぐらぐら	wobble
グラウンド	グラウンド	sports field
くっつける	くっ付ける	join, paste
くっつく	くっ付く	stick, cling
ぐっすり	ぐっすり	soundly
クッキー	クッキー	cookie, biscuit
くだらない	くだらない	worthless, trifling
くたびれる	くたびれる	get tired, be worn out
くたくた	くたくた	exhausted
くすぐる	くすぐる	tickle
くすぐったい	くすぐったい	ticklish
ぐずぐず	ぐずぐず	drag one's feet, waste time
くしゃみ	くしゃみ	sneeze
くしゃくしゃ	くしゃくしゃ	messy, scrunch
くし	くし	comb
クイズ	クイズ	quiz, quiz show
クーラー	クーラー	air conditioning, cooler
きれ	きれ	a cut of cloth
きりすときょう	キリスト教	Christianity
キリスト	キリスト	Christ, Christianity
ぎりぎり	ぎりぎり	just in time, barely
きらりと	きらりと	sparkle
ぎらぎら	ぎらぎら	dazzling, glaring, blinding
きらきら	きらきら	shining, sparkling
きょろきょろ	きょろきょろ	look around
ぎょうざ	ぎょうざ	Chinese dumpling
きゅうり	きゅうり	cucumber
ぎゅうぎゅう	ぎゅうぎゅう	packed, crammed
キャンプ	キャンプ	camping, camp
キャンセル	キャンセル	cancellation
キャベツ	キャベツ	cabbage
キャッシュカード	キャッシュカード	cash card
きっと	きっと	surely, certainly
きっちん	きっちん	kitchen
きっちり	きっちり	exactly
ぎっしり	ぎっしり	tightly
きっかけ	きっかけ	chance, opportunity
きつい	きつい	tight, difficult
きつい	きつい	severe, hard, strict
きちんと	きちんと	properly, neatly
ギター	ギター	guitar
キス	キス	kiss
カンニング	カンニング	cheating
かんかん	かんかん	furious
がん	がん	cancer
カレンダー	カレンダー	calendar
カレーライス	カレーライス	curried rice
がらすど	ガラス戸	glass door
ガラス	ガラス	glass
からす	からす	crow, raven
がらがら	がらがら	empty
がらがら	がらがら	gargle
からから	からから	thirsty, dry
からから	からから	roar, laugh loudly
からかう	からかう	make fun of, tease
カラオケ	カラオケ	karaoke
カラー	カラー	color
かゆい	かゆい	itchy
がやがや	がやがや	chatter loudly
カメラマン	カメラマン	photographer, cameraman
カメラ	カメラ	camera
かみそり	かみそり	razor
かぼちゃ	かぼちゃ	pumpkin
がぶがぶ	がぶがぶ	(the sound of) guzzling
カバー	カバー	cover, covering
かなり	かなり	fairly, rather
カップ	カップ	cup
かっと	カット	cut
かっと	かっと	lose one's temper, fly into a rage
かつて	かつて	once, formerly
がっかり	がっかり	feel disappointed
かちかち	かちかち	hard, solid
カタログ	カタログ	catalogue
がたがた	がたがた	rattle
ガソリンスタンド	ガソリンスタンド	gas station
ガソリン	ガソリン	gasoline
カセットテープ	カセットテープ	cassette tape
ガス	ガス	gas
かじる	かじる	nibble, bite
がさがさ	がさがさ	rustle
がくんと	がくんと	sharply
かかる	かかる	catch, get
かかと	かかと	heel
かえる	かえる	frog
かえって	かえって	on the contrary, rather
ガイド	ガイド	guide
ガールフレンド	ガールフレンド	girlfriend
カーブ	カーブ	curve, bend
ガード	ガード	guard rail
カード	カード	card, credit card
カーテン	カーテン	curtain
おねがい	お願い	favor
おかげ	お陰	help, thanks to
おつり	お釣り	change
おじぎ	お辞儀	bow
おわび	お詫び	apologize
おかし	お菓子	sweets, snacks
おちゃ	お茶	tea (polite)
おいわい	お祝い	celebrate
おじいさん	お祖父さん	grandfather
おばあさん	お祖母さん	grandmother
おれい	お礼	thanks, reward, return present
おめにかかる	お目に掛かる	meet, have the honor of seeing
おとうさん	お父さん	father
おかあさん	お母さん	mother
おせいぼ	お歳暮	year-end gift
おてあらい	お手洗い	toilet, bathroom
おてつだい	お手伝い	helper, assistant
おとしだま	お年玉	New Year's gift
おまわりさん	お巡りさん	policeman
おたく	お宅	your home, you, fan, geek
おじょうさん	お嬢さん	young lady, your daughter
おじょうさん	お嬢さん	young lady, someone's daughter
おねえさん	お姉さん	older sister
おぼうさん	お坊さん	monk, priest
おみやげ	お土産	souvenir
おまいり	お参り	visiting a shrine or temple
おいしゃさん	お医者さん	doctor
おまえ	お前	you, darling
おにいさん	お兄さん	older brother
おしまい	お仕舞い	finished, over
おたがい	お互い	each other
おちゅうげん	お中元	mid-year gift, summer gift
おせじ	お世辞	compliment, flattery
オレンジ	オレンジ	orange
オルガン	オルガン	organ, pipe organ
オリンピック	オリンピック	the Olympics
およそ	およそ	just about
おやつ	おやつ	snack, refreshment
おもちゃ	おもちゃ	toy, plaything
おまけ	おまけ	free gift
おばさん	おばさん	aunt
おばさん	おばさん	middle-aged woman
おば	おば	aunt
おにぎり	おにぎり	rice ball
おなか	おなか	stomach
おっしゃる	おっしゃる	say
おだてる	おだてる	flatter
おしゃれ	おしゃれ	dressing up smartly, trendy
おしゃべり	おしゃべり	chatter, talkative
おしゃべり	おしゃべり	chatter, idle talk
おじさん	おじさん	uncle
おじさん	おじさん	Mister, middle-aged man
おじ	おじ	uncle
おごる	おごる	treat
おかず	おかず	side dish
おかしい	おかしい	strange, peculiar, suspicious
おかしい	おかしい	funny, amusing, comical
おいしい	おいしい	tasty
オーバー	オーバー	exaggerate
オートバイ	オートバイ	motorbike, motorcycle
オーケストラ	オーケストラ	orchestra, orchestral music
エンジン	エンジン	engine
エレベーター	エレベーター	elevator
えび	えび	lobster, shrimp
エネルギー	エネルギー	energy
エチケット	エチケット	etiquette
エスカレーター	エスカレーター	escalator
エイズ	エイズ	AIDS
エアメール	エアメール	airmail
エアコン	エアコン	air-conditioning, air conditioner
うろうろ	うろうろ	wander
うるさい	うるさい	noisy, annoying, pesky
うるさい	うるさい	noisy, bothersome
うまい	うまい	good at
うまい	うまい	delicious, tasty
うなずく	うなずく	nod
ウナギ	ウナギ	eel
うどん	うどん	noodles, Japanese wheat noodles
うつむく	うつむく	face downward
うっかり	うっかり	carelessly, accidentally
うちわ	うちわ	round paper fan
ウサギ	ウサギ	rabbit, hare
うきうき	うきうき	feel excited
うがい	うがい	gargling
ウエスト	ウエスト	the waist
ウェートレス	ウェートレス	waitress
ウェーター	ウェーター	waiter
ウィスキー	ウィスキー	whisky
ウィークエンド	ウィークエンド	weekend
ウール	ウール	wool
インフレーション	インフレーション	inflation
イントネーション	イントネーション	intonation
インテリ	インテリ	intelligent
インタビュー	インタビュー	interview
インク	インク	ink
いらっしゃる	いらっしゃる	come, go
いらいら	いらいら	be irritated
いよいよ	いよいよ	finally, any moment
イヤリング	イヤリング	earrings
いやらしい	いやらしい	disgusting, nasty
いやいや	いやいや	reluctantly
イメージ	イメージ	image
いびき	いびき	snoring
いつも	いつも	always
いつも	いつも	always, usually
いつまでも	いつまでも	forever
いつのまにか	いつのまにか	before it is noticed
いつのまに	いつのまに	when
いつでも	いつでも	always, at all times
いつごろ	いつごろ	about when, about what time
いつか	いつか	some time, some day
いつ	いつ	when
いちいち	いちいち	one by one, in detail
いたずら	いたずら	mischief, prank
いずれ	いずれ	eventually, sometime
イスラムきょう	イスラム教	Islam, Muslim religion
いけない	いけない	wrong, must not
いきなり	いきなり	all of a sudden, without warning
いかにも	いかにも	indeed, as if
いかに	いかに	how, in what way
いかが	いかが	how, what
いか	いか	squid
いいかげん	いい加減	irresponsible, half-baked
あんまり	あんまり	(not) that much, (not) so much
あんなに	あんなに	that, so
アンテナ	アンテナ	antenna
アンケート	アンケート	questionnaire
あれこれ	あれこれ	this and that, one thing or another
あれ	あれ	that over there
アルミニウム	アルミニウム	aluminum
アルファベット	アルファベット	alphabet
アルバム	アルバム	album
アルバイト	アルバイト	casual job, student job, part-time job
アルコール	アルコール	alcohol, alcoholic beverage
あり	あり	ant
あらかじめ	あらかじめ	in advance
あまり	あまり	(not) much
アマチュア	アマチュア	amateur
あふれる	あふれる	over flow, flood
アパート	アパート	apartment, flat, apartment house
あなた	あなた	you
アナウンサー	アナウンサー	news reader, announcer
アドバイス	アドバイス	advice
アップ	アップ	close-up
あっち	あっち	other side, there
あっさり	あっさり	plainly, matter-of-factly
あちらこちら	あちらこちら	all over, here and there
あちら	あちら	way over there
あちこち	あちこち	all over
あだな	あだな	nickname
あそこ	あそこ	over there
あげる	あげる	give
あぐら	あぐら	sit cross legged
あくび	あくび	yawn
アクセント	アクセント	accent, stress
アクセサリー	アクセサリー	accessories, jewelry
あきれる	あきれる	be stunned in disappointment or disbelief
あえて	あえて	boldly
アイロン	アイロン	iron
あいにく	あいにく	unfortunately
アイドル	アイドル	idol, pop singer
アイデア	アイデア	idea
あいづち	あいづち	responsive sounds, chiming in
アイスコーヒー	アイスコーヒー	iced coffee
アイスクリーム	アイスクリーム	ice cream
アイス	アイス	popsicle, ice lolly
ああ	ああ	that kind of
